municipio,populacaototal_homem,populacaototal_mulher,populacaototal,populacaojovem_homem,populacaojovem_mulher,populacaojovem
1100015,12656,11736,24392,3520,3360,6880
1100023,45543,44810,90353,13096,13384,26480
1100031,3266,3047,6313,793,772,1565
1100049,39124,39450,78574,11222,11413,22635
1100056,8551,8478,17029,2321,2368,4689
1100064,9330,9261,18591,2484,2570,5054
1100072,4711,4072,8783,1287,1134,2421
1100080,7202,6476,13678,2003,1811,3814
1100098,14606,14123,28729,4005,4042,8047
1100106,20947,20709,41656,5842,5781,11623
1100114,26005,26000,52005,7600,7610,15210
1100122,57824,58786,116610,16799,17309,34108
1100130,16536,14599,31135,4450,4156,8606
1100148,10344,9530,19874,2899,2699,5598
1100155,18698,19230,37928,5399,5511,10910
1100189,17041,16781,33822,5054,4864,9918
1100205,217618,210909,428527,67116.39,65363.22,132479.6
1100254,11309,11010,22319,3054,2946,6000
1100262,1767,1549,3316,410,430,840
1100288,25170,25478,50648,7245,7627,14872
1100296,4596,4290,8886,1230,1168,2398
1100304,37782,38420,76202,10987,11344,22331
1100320,11328,10500,21828,3122,3125,6247
1100338,11735,10811,22546,3065,3078,6143
1100346,8678,8175,16853,2319,2268,4587
1100379,6739,6077,12816,1830,1689,3519
1100403,9022,8113,17135,2289,2183,4472
1100452,16741,15642,32383,4627,4698,9325
1100502,5336,4904,10240,1363,1312,2675
1100601,2965,2771,5736,742,750,1492
1100700,6768,5897,12665,1825,1610,3435
1100809,10320,9459,19779,2780,2749,5529
1100908,1829,1746,3575,442,459,901
1100924,4415,3886,8301,1226,1144,2370
1100940,8456,7398,15854,2312,2182,4494
1101005,5470,5042,10512,1478,1372,2850
1101104,4565,4001,8566,1162,1077,2239
1101203,5304,5048,10352,1392,1441,2833
1101302,6049,5829,11878,1613,1629,3242
1101401,7408,6683,14091,1860,1871,3731
1101435,3999,3494,7493,1090,1008,2098
1101450,2595,2215,4810,719,659,1378
1101468,1218,1097,2315,292,274,566
1101476,1856,1668,3524,471,401,872
1101484,3086,2932,6018,734,784,1518
1101492,8415,7620,16035,2326,2186,4512
1101500,6087,5542,11629,1650,1590,3240
1101559,2540,2348,4888,737,605,1342
1101609,5653,4996,10649,1466,1311,2777
1101708,6731,6243,12974,1801,1811,3612
1101757,4979,4405,9384,1254,1226,2480
1101807,4244,3966,8210,1125,1108,2233
1200013,6592,5946,12538,1718,1647,3365
1200054,3091,2981,6072,875,873,1748
1200104,11037,10361,21398,3062,2989,6051
1200138,4569,3902,8471,1138,1101,2239
1200179,4655,4143,8798,1134,1051,2185
1200203,39220,39287,78507,11712,11938,23650
1200252,7626,7474,15100,2112,2224,4336
1200302,16716,15696,32412,4721,4447,9168
1200328,3412,3165,6577,958,870,1828
1200336,7836,7370,15206,2266,2148,4414
1200344,4255,3726,7981,1183,1053,2236
1200351,7463,6764,14227,2200,1977,4177
1200385,8999,8210,17209,2383,2122,4505
1200393,4794,4382,9176,1291,1108,2399
1200401,163592,172446,336038,49198,52448,101646
1200427,7479,6910,14389,2051,1926,3977
1200435,2406,2285,4691,742,647,1389
1200450,10328,9851,20179,2779,2769,5548
1200500,19739,18290,38029,5979,5560,11539
1200609,18353,17237,35590,5222,4822,10044
1200708,8317,7774,16091,2327,2120,4447
1200807,7845,7035,14880,1946,1899,3845
1300029,7416,6672,14088,2078,1844,3922
1300060,4902,4565,9467,1403,1411,2814
1300086,5446,4768,10214,1575,1402,2977
1300102,8511,7806,16317,2444,2308,4752
1300144,9551,8456,18007,2720,2661,5381
1300201,7852,7301,15153,2555,2359,4914
1300300,16989,15146,32135,4481,4047,8528
1300409,13816,11902,25718,4661,4016,8677
1300508,14312,13043,27355,3832,3275,7107
1300607,17260,16151,33411,5005,4837,9842
1300631,8146,7340,15486,2185,1964,4149
1300680,7945,7034,14979,2270,1945,4215
1300706,15947,14685,30632,4605,4122,8727
1300805,18237,16724,34961,5383,4893,10276
1300839,5812,5163,10975,1678,1516,3194
1300904,6872,5866,12738,1906,1744,3650
1301001,13259,12515,25774,3826,3559,7385
1301100,16990,15744,32734,4448,4465,8913
1301159,12688,11242,23930,3290,3107,6397
1301209,39476,36489,75965,12602,11984,24586
1301308,12107,11099,23206,3631,3444,7075
1301407,15779,14886,30665,4763,4310,9073
1301506,8392,7946,16338,2558,2326,4884
1301605,11824,10993,22817,3476,3330,6806
1301654,7265,6709,13974,2183,1941,4124
1301704,23204,21023,44227,6940,6449,13389
1301803,11355,10899,22254,3027,3016,6043
1301852,20996,19785,40781,5688,5474,11162
1301902,44426,42413,86839,12176,11894,24070
1301951,4236,3802,8038,1259,1117,2376
1302009,4299,3912,8211,1168,1155,2323
1302108,3835,3491,7326,1141,1099,2240
1302207,5548,5254,10802,1656,1541,3197
1302306,9432,8560,17992,2540,2427,4967
1302405,19638,18063,37701,5793,5275,11068
1302504,43461,41680,85141,12231.87,12253.66,24485.52
1302553,11744,11057,22801,3180.526,3130.688,6311.214
1302603,879742,922272,1802014,263501,277861,541362
1302702,24684,22333,47017,7173,6637,13810
1302801,9407,8121,17528,2926,2471,5397
1302900,27283,24953,52236,7587,6786,14373
1303007,9496,8782,18278,2718,2427,5145
1303106,15748,14948,30696,4655,4549,9204
1303205,7607,7116,14723,2213,2109,4322
1303304,11429,10022,21451,3252,3031,6283
1303403,52304,49729,102033,14719,14183,28902
1303502,9490,8676,18166,2893,2553,5446
1303536,14350,12825,27175,3846,3629,7475
1303569,13406,12313,25719,3873,3838,7711
1303601,9322,8824,18146,2518,2338,4856
1303700,12592,11889,24481,3602,3478,7080
1303809,19463,18433,37896,5437,4980,10417
1303908,16266,15156,31422,4631,4387,9018
1303957,5680,5025,10705,1606,1486,3092
1304005,4498,3946,8444,1183,1012,2195
1304062,26359,25913,52272,7645,7792,15437
1304104,10075,9002,19077,3037,2834,5871
1304203,31518,29935,61453,9241,8869,18110
1304237,8777,8302,17079,2626,2447,5073
1304260,6332,5559,11891,1735,1666,3401
1304302,8854,8240,17094,2280,2204,4484
1304401,9529,8308,17837,2806,2457,5263
1400027,4992,4335,9327,1232,1069,2301
1400050,8676,7772,16448,2161,1931,4092
1400100,140801,143512,284313,43464,45421,88885
1400159,5879,5064,10943,1491,1265,2756
1400175,7538,6364,13902,1763,1496,3259
1400209,9732,8666,18398,2646,2439,5085
1400233,4309,3805,8114,1172,1103,2275
1400282,4600,4096,8696,1208,1187,2395
1400308,7865,6927,14792,2054.105,1897.324,3951.43
1400407,4678,4262,8940,1192,1084,2276
1400456,5408,5025,10433,1311,1340,2651
1400472,12923,11356,24279,3837.129,3163.278,7000.407
1400506,3551,3218,6769,1051,986,2037
1400605,3568,3182,6750,1112,1036,2148
1400704,4339,4036,8375,1109,1037,2146
1500107,71630,69470,141100,22884,21902,44786
1500131,3533,3247,6780,1017,937,1954
1500206,28115,25454,53569,8241,7478,15719
1500305,18453,16589,35042,5470,4751,10221
1500347,13618,11439,25057,4019,3830,7849
1500404,27030,25596,52626,7226,6745,13971
1500503,17468,16146,33614,4929,4729,9658
1500602,49819,49256,99075,14661,14958,29619
1500701,12957,11802,24759,3723,3427,7150
1500800,226635,245345,471980,67292,73070,140362
1500859,10992,9551,20543,3148,2940,6088
1500909,20989,19508,40497,6195,5499,11694
1500958,13620,12926,26546,3972,3995,7967
1501006,8367,7482,15849,2155,1971,4126
1501105,12135,11729,23864,3566,3571,7137
1501204,19446,17436,36882,5916,5203,11119
1501253,1847,1584,3431,480,427,907
1501303,50346,49513,99859,15484,15397,30881
1501402,659008,734391,1393399,190717,208144,398861
1501451,8481,7837,16318,2144,2014,4158
1501501,25815,25836,51651,7721,7784,15505
1501576,8051,7247,15298,2334,2089,4423
1501600,7114,6516,13630,2150,2062,4212
1501709,57291,55936,113227,17217,17040,34257
1501725,8314,7376,15690,2281,2091,4372
1501758,3832,3485,7317,1095,1021,2116
1501782,27085,25408,52493,7889,7747,15636
1501808,47788,45072,92860,13937.65,12633.33,26570.98
1501907,13335,12360,25695,3776,3494,7270
1501956,13720,12764,26484,3839,3727,7566
1502004,10545,9898,20443,3127,2893,6020
1502103,62016,58880,120896,18903,17669,36572
1502152,13585,13131,26716,4086,4211,8297
1502202,31494,32145,63639,9135,9323,18458
1502301,26621,25272,51893,7870,7549,15419
1502400,84476,88673,173149,25935,27396,53331
1502509,11180,9825,21005,3187,2673,5860
1502608,5879,5502,11381,1658,1560,3218
1502707,23309,22248,45557,6089,5934,12023
1502756,14590,13626,28216,4461,4297,8758
1502764,6081,4385,10466,1504,1261,2765
1502772,9666,8622,18288,2595,2515,5110
1502806,15059,13490,28549,4421,3955,8376
1502855,6456,5798,12254,1885,1568,3453
1502905,17568,16726,34294,4969,4507,9476
1502939,26624,24695,51319,8114,7577,15691
1502954,16814,14972,31786,4655,4373,9028
1503002,4240,3937,8177,1194,1114,2308
1503044,9551,8217,17768,2658,2335,4993
1503077,13107,11927,25034,3932,3537,7469
1503093,15750,14686,30436,4738,4647,9385
1503101,15400,13662,29062,4449,3990,8439
1503200,18117,17770,35887,5442,5308,10750
1503309,29674,28403,58077,9111,8776,17887
1503408,5170,4867,10037,1511,1476,2987
1503457,26904,24405,51309,8225,8018,16243
1503507,16261,15103,31364,4629,4142,8771
1503606,49681,47812,97493,14533,14572,29105
1503705,27026,24194,51220,7501,7136,14637
1503754,8037,6066,14103,2059,1771,3830
1503804,25769,25591,51360,8074,8282,16356
1503903,24578,22508,47086,7184,6447,13631
1504000,13115,11906,25021,4006,3581,7587
1504059,13740,14164,27904,3993,4216,8209
1504109,4258,3857,8115,1218,1044,2262
1504208,118196,115473,233669,36539,36541,73080
1504307,14699,13677,28376,4060,3678,7738
1504406,13884,12721,26605,3793,3423,7216
1504422,53884,54362,108246,15880,16898,32778
1504455,14888,12440,27328,4360,3808,8168
1504505,13227,11581,24808,3977,3448,7425
1504604,13747,12984,26731,4099,3716,7815
1504703,36666,33352,70018,11036,10047,21083
1504802,28508,26954,55462,7707,7387,15094
1504901,17906,16298,34204,5406,4856,10262
1504950,10643,9515,20158,3206,2893,6099
1504976,7731,6914,14645,2164,1994,4158
1505007,7082,6588,13670,1997,1825,3822
1505031,13435,11689,25124,3540,3428,6968
1505064,32748,29302,62050,9202,8772,17974
1505106,25563,23770,49333,6807,6453,13260
1505205,15017,13578,28595,4269,3785,8054
1505304,31756,31038,62794,8686,8782,17468
1505403,8443,7868,16311,2427,2232,4659
1505437,14270,13089,27359,4485,4307,8792
1505486,21599,18380,39979,6228,5500,11728
1505494,3879,3596,7475,1124,1040,2164
1505502,49267,48552,97819,15129,15681,30810
1505536,77893,76015,153908,25783,26598,52381
1505551,3178,2855,6033,912,799,1711
1505601,4039,3815,7854,1123,1061,2184
1505635,6776,5921,12697,1800,1677,3477
1505650,12568,11366,23934,3605,3495,7100
1505700,13379,12620,25999,3993,3769,7762
1505809,26818,25354,52172,7502,7058,14560
1505908,17612,16344,33956,5240,4969,10209
1506005,15516,13833,29349,4343,3825,8168
1506104,5300,4968,10268,1531,1354,2885
1506112,6461,5950,12411,1862,1675,3537
1506138,38016,37540,75556,11050,11143,22193
1506161,9161,8536,17697,2595,2451,5046
1506187,24274,22690,46964,7241,6892,14133
1506195,20875,19212,40087,6028,5720,11748
1506203,19096,18325,37421,5831,5562,11393
1506302,10292,9891,20183,3015,2785,5800
1506351,8755,8386,17141,2482,2456,4938
1506401,4142,4013,8155,1303,1241,2544
1506500,31156,28310,59466,10329,8574,18903
1506559,9884,9540,19424,2964,2883,5847
1506583,9497,7709,17206,2338,1972,4310
1506609,11492,11534,23026,3343,3378,6721
1506708,29788,26365,56153,8325,8282,16607
1506807,145533,149047,294580,43039,44228,87267
1506906,3211,2930,6141,917,840,1757
1507003,13433,13241,26674,3953,3855,7808
1507102,8806,8085,16891,2587,2306,4893
1507151,11901,11229,23130,3322,3216,6538
1507201,15741,14105,29846,4439,3915,8354
1507300,48691,42649,91340,13918,14350,28268
1507409,7775,7285,15060,2268,2078,4346
1507458,13093,12494,25587,3675,3636,7311
1507466,2738,2527,5265,752,708,1460
1507474,10760,9887,20647,3196,2763,5959
1507508,7149,6006,13155,1984,1646,3630
1507607,26028,25539,51567,7775,7495,15270
1507706,11833,11071,22904,3749,3340,7089
1507755,2710,2337,5047,766,690,1456
1507805,6995,6050,13045,1876,1673,3549
1507904,11472,11529,23001,3432,3275,6707
1507953,40991,38306,79297,12925,13268,26193
1507961,5272,4990,10262,1531,1396,2927
1507979,8776,8173,16949,2491.083,2386.997,4878.08
1508001,29323,27195,56518,8636,8229,16865
1508035,14328,13127,27455,4194,3846,8040
1508050,9146,7729,16875,2723,2490,5213
1508084,17489,16201,33690,5246,5075,10321
1508100,48402,48726,97128,15048,15378,30426
1508126,22209,21132,43341,6473,6738,13211
1508159,23633,21156,44789,6838,6696,13534
1508209,24548,23341,47889,7472,6967,14439
1508308,29817,26899,56716,8742,7496,16238
1508357,7281,6150,13431,2215.689,2032.039,4247.728
1508407,20572,20001,40573,5982,5972,11954
1600055,2333,2047,4380,636,593,1229
1600105,4211,3858,8069,1247,1092,2339
1600154,5866,4906,10772,1620,1476,3096
1600204,4821,4179,9000,1183,1145,2328
1600212,2424,2272,4696,687,683,1370
1600238,3046,2756,5802,832.1199,745.3585,1577.479
1600253,2320,1945,4265,650,551,1201
1600279,20434,19508,39942,5946,6074,12020
1600303,195613,202591,398204,60393.77,63793.77,124187.5
1600402,8974,8058,17032,2564,2201,4765
1600501,10704,9805,20509,3134,2961,6095
1600535,8872,7937,16809,2447,2296,4743
1600550,1997,1796,3793,507,485,992
1600600,50414,50848,101262,16005,16271,32276
1600709,6679,5884,12563,1839,1623,3462
1600808,6427,6001,12428,1984,1851,3835
1700251,1261,1130,2391,275,285,560
1700301,2618,2544,5162,775,784,1559
1700350,2907,2764,5671,740,664,1404
1700400,3965,3621,7586,1017,944,1961
1700707,4252,4122,8374,1122,1074,2196
1701002,4981,4884,9865,1397,1358,2755
1701051,1673,1502,3175,414,416,830
1701101,2170,2043,4213,519,530,1049
1701309,3138,2744,5882,741,664,1405
1701903,3331,2986,6317,832,771,1603
1702000,4511,4275,8786,1042,979,2021
1702109,73587,76897,150484,23100,24619,47719
1702158,2584,2446,5030,704,662,1366
1702208,15968,15361,31329,4295,4249,8544
1702307,3447,3295,6742,901,888,1789
1702406,5393,5252,10645,1414,1343,2757
1702554,8005,7945,15950,2410,2374,4784
1702703,1774,1672,3446,442,376,818
1702901,4600,4675,9275,1299,1287,2586
1703008,5540,4884,10424,1484,1308,2792
1703057,1692,1430,3122,421,379,800
1703073,2195,1928,4123,559,503,1062
1703107,2758,2591,5349,737,662,1399
1703206,2325,2131,4456,623,548,1171
1703305,1989,1779,3768,576,530,1106
1703602,1057,1007,2064,244,264,508
1703701,2599,2586,5185,726,689,1415
1703800,4939,4829,9768,1546,1502,3048
1703826,1137,1011,2148,296,278,574
1703842,4264,3875,8139,1242,1055,2297
1703867,2106,1650,3756,627,447,1074
1703883,1206,1110,2316,349,291,640
1703891,1919,1769,3688,548,514,1062
1703909,2384,2217,4601,584,546,1130
1704105,1375,1191,2566,360,304,664
1704600,716,619,1335,164.0874,146.9126,311
1705102,1792,1485,3277,436,359,795
1705508,15288,15550,30838,4375,4536,8911
1705557,2374,2295,4669,624,638,1262
1705607,2132,2050,4182,547,502,1049
1706001,2638,2371,5009,722,599,1321
1706100,3699,3535,7234,891,810,1701
1706258,821,743,1564,178,161,339
1706506,2775,2498,5273,719,659,1378
1707009,9679,9433,19112,2735,2730,5465
1707108,3280,3083,6363,805,756,1561
1707207,3958,3203,7161,870,744,1614
1707306,2440,2152,4592,599,569,1168
1707405,4910,4566,9476,1379,1321,2700
1707553,1909,1896,3805,483,461,944
1707652,2705,2635,5340,627,611,1238
1707702,4470,4035,8505,1201,1045,2246
1708205,9607,8820,18427,2468,2267,4735
1708254,1234,1185,2419,342,320,662
1708304,2649,2307,4956,642,553,1195
1709005,6287,5777,12064,1652,1445,3097
1709302,11687,11513,23200,3222,3238,6460
1709500,38107,38648,76755,11369,11524,22893
1709807,864,775,1639,221,206,427
1710508,3731,3373,7104,927,820,1747
1710706,3104,2925,6029,800,738,1538
1710904,1913,1619,3532,477,398,875
1711100,1285,1160,2445,339,295,634
1711506,1815,1692,3507,373,371,744
1711803,1176,1055,2231,312,282,594
1711902,5525,4685,10210,1508,1300,2808
1711951,1830,1695,3525,460,412,872
1712009,1464,1309,2773,377,353,730
1712157,838,767,1605,200,191,391
1712405,2007,1718,3725,503,366,869
1712454,1350,1272,2622,343,340,683
1712504,2318,2034,4352,551,520,1071
1712702,1187,1036,2223,324,291,615
1712801,1697,1457,3154,413,374,787
1713205,10347,10337,20684,2904,2864,5768
1713304,6423,6200,12623,1653,1625,3278
1713601,3601,3115,6716,881,735,1616
1713700,1120,965,2085,263,227,490
1713809,2991,2749,5740,878,755,1633
1713957,1657,1495,3152,445,378,823
1714203,4596,4404,9000,1230,1197,2427
1714302,2262,2124,4386,570,538,1108
1714880,5576,5110,10686,1463,1406,2869
1715002,1965,1805,3770,449,402,851
1715101,1921,1841,3762,534,489,1023
1715150,1180,1106,2286,287,306,593
1715259,1277,1180,2457,320,302,622
1715507,552,485,1037,130.8435,114.0127,244.8562
1715705,2659,2295,4954,655,547,1202
1715754,3704,3635,7339,924,937,1861
1716109,22113,22304,44417,6391,6482,12873
1716208,5444,4894,10338,1424,1298,2722
1716307,2459,2129,4588,661,576,1237
1716505,5969,5570,11539,1828,1664,3492
1716604,5427,4957,10384,1311,1180,2491
1716653,2667,2387,5054,645,588,1233
1716703,4368,4243,8611,1085,1031,2116
1717008,2385,2121,4506,627,543,1170
1717206,1626,1294,2920,397,345,742
1717503,3526,3168,6694,859,822,1681
1717800,2405,2139,4544,589,489,1078
1717909,3879,3301,7180,1025,866,1891
1718006,1431,1365,2796,369,369,738
1718204,24517,24629,49146,7205,7284,14489
1718303,3897,3762,7659,1089,1025,2114
1718402,1882,1799,3681,500,453,953
1718451,1257,1112,2369,319,285,604
1718501,2008,1760,3768,527,438,965
1718550,2168,2023,4191,561,538,1099
1718659,886,828,1714,279,241,520
1718709,1361,1209,2570,348,307,655
1718758,3379,2875,6254,882,691,1573
1718808,1970,1894,3864,515,521,1036
1718840,1741,1585,3326,368,386,754
1718865,3417,3182,6599,979,927,1906
1718881,1518,1376,2894,377,357,734
1718899,1109,1019,2128,231,229,460
1718907,2411,2157,4568,546,509,1055
1719004,1339,1184,2523,373,305,678
1720002,1268,1206,2474,359,350,709
1720101,2403,2205,4608,639,605,1244
1720150,770,667,1437,206,158,364
1720200,5290,5191,10481,1517,1435,2952
1720259,1486,1424,2910,454.2292,345.9209,800.1501
1720309,2199,2084,4283,625,583,1208
1720499,2267,2116,4383,526,495,1021
1720655,2655,2413,5068,671,618,1289
1720804,4631,4517,9148,1354,1260,2614
1720853,894,848,1742,210,203,413
1720903,7884,7167,15051,2131,1893,4024
1720937,1017,928,1945,282,231,513
1720978,1351,1211,2562,339,314,653
1721000,112848,115484,228332,36980,39809,76789
1721109,3476,3260,6736,946,900,1846
1721208,11200,11419,22619,3293,3200,6493
1721257,843,731,1574,225,187,412
1721307,1087,1010,2097,223,220,443
1722081,5647,5334,10981,1481,1420,2901
1722107,5907,5577,11484,1712,1582,3294
2100055,52115,51932,104047,15501,15942,31443
2100105,2972,2933,5905,849,832,1681
2100154,6018,5563,11581,1699,1655,3354
2100204,11258,10593,21851,3265,2950,6215
2100303,12395,11557,23952,3585,3226,6811
2100402,5567,5496,11063,1642.395,1512.736,3155.131
2100436,12274,12325,24599,3515,3698,7213
2100477,16022,15035,31057,4545,4257,8802
2100501,5468,5298,10766,1569,1372,2941
2100550,3312,3119,6431,937,914,1851
2100600,19782,18150,37932,5312.449,4687.792,10000.24
2100709,12959,12332,25291,3747,3569,7316
2100808,7020,6919,13939,2037,2075,4112
2100832,7816,7143,14959,2520,2220,4740
2100873,7119,6854,13973,1993,1972,3965
2100907,22007,20498,42505,6298,5768,12066
2100956,16483,15219,31702,4923,4434,9357
2101004,14315,14173,28488,4237,4254,8491
2101103,5822,5585,11407,1771,1627,3398
2101202,47757,52257,100014,13791,14763,28554
2101251,7510,7415,14925,2382,2354,4736
2101301,8487,8117,16604,2684,2351,5035
2101350,2745,2548,5293,790,710,1500
2101400,41574,41954,83528,12897,13206,26103
2101509,8937,8904,17841,2716,2640,5356
2101608,41656,41174,82830,11902,11655,23557
2101707,28132,26798,54930,7954.332,7901.004,15855.34
2101731,3423,3101,6524,944,849,1793
2101772,6109,5940,12049,1789,1722,3511
2101806,2855,2614,5469,781,677,1458
2101905,10349,9995,20344,2948,2755,5703
2101939,2973,3023,5996,786,827,1613
2101970,4041,3908,7949,1088,1104,2192
2102002,19850,19199,39049,5449,5291,10740
2102036,14872,13587,28459,4684,4278,8962
2102077,7553,7265,14818,2140,2090,4230
2102101,16883,16476,33359,4831,4584,9415
2102150,2867,2710,5577,816,787,1603
2102200,13678,13335,27013,3793,3612,7405
2102309,11325,11574,22899,3055,3053,6108
2102325,33316,31921,65237,9569,9715,19284
2102358,7536,7248,14784,2052,1935,3987
2102374,4403,4043,8446,1271,1178,2449
2102408,5365,5228,10593,1630,1545,3175
2102507,9509,8829,18338,2843,2557,5400
2102556,6819,6550,13369,2047,2003,4050
2102606,9690,8815,18505,2981,2668,5649
2102705,10254,10194,20448,2983,2955,5938
2102754,5345,5353,10698,1553,1446,2999
2102804,12285,11674,23959,3345,3009,6354
2102903,11338,10668,22006,3510,3224,6734
2103000,75082,80047,155129,21627,22252,43879
2103109,5395,4902,10297,1498,1395,2893
2103125,4087,3800,7887,1075,1059,2134
2103158,6641,5924,12565,2173,1855,4028
2103174,9331,8291,17622,2717,2518,5235
2103208,36243,37107,73350,10451,10724,21175
2103257,7011,6670,13681,1984,1847,3831
2103307,57403,60635,118038,16371,16561,32932
2103406,23002,23748,46750,6556,6714,13270
2103505,19395,19737,39132,5902,5749,11651
2103554,7481,6955,14436,2073,1900,3973
2103604,30662,31063,61725,8421,8551,16972
2103703,16599,16053,32652,4541,4206,8747
2103752,6271,6308,12579,1843,1764,3607
2103802,10950,11731,22681,3027,3294,6321
2103901,5383,5266,10649,1548,1470,3018
2104008,9075,9377,18452,2617,2694,5311
2104057,19017,16818,35835,5980,5337,11317
2104073,4266,3860,8126,1158,973,2131
2104081,4839,4402,9241,1420,1241,2661
2104099,9324,8433,17757,2916,2640,5556
2104107,5972,5674,11646,1851,1697,3548
2104206,7612,7486,15098,1988,1922,3910
2104305,5566,5069,10635,1708,1561,3269
2104404,8677,8805,17482,2375,2325,4700
2104503,5066,5139,10205,1463,1455,2918
2104552,8152,7743,15895,2323,2248,4571
2104602,8060,7931,15991,2187,2145,4332
2104628,3750,3587,7337,1025,1001,2026
2104651,6015,5906,11921,1742,1739,3481
2104677,12863,12538,25401,3776,3781,7557
2104701,3031,3109,6140,871,815,1686
2104800,31696,30397,62093,9653,9178,18831
2104909,6140,5941,12081,1782,1604,3386
2105005,13684,12505,26189,3809,3382,7191
2105104,13092,12053,25145,3802,3282,7084
2105153,6348,6202,12550,1907,1878,3785
2105203,5426,5615,11041,1547,1546,3093
2105302,119227,128278,247505,35941,38831,74772
2105351,7388,6909,14297,2232,2072,4304
2105401,31025,31085,62110,9030,8998,18028
2105427,12588,12275,24863,3534,3494,7028
2105450,4303,4223,8526,1199,1189,2388
2105476,7976,7464,15440,2308,2123,4431
2105500,9977,10404,20381,2902,2890,5792
2105609,7815,7618,15433,2248,2154,4402
2105658,2007,2013,4020,585,582,1167
2105708,22965,23118,46083,6654,6627,13281
2105807,5415,5314,10729,1584,1450,3034
2105906,7729,7683,15412,2203,2111,4314
2105922,5609,5325,10934,1674,1604,3278
2105948,3866,3928,7794,1054,1024,2078
2105963,5544,4973,10517,1649,1422,3071
2105989,3624,3299,6923,998,939,1937
2106003,5615,5808,11423,1576,1512,3088
2106102,5870,5520,11390,1855,1637,3492
2106201,3399,3111,6510,1021,931,1952
2106300,8979,8608,17587,2588,2603,5191
2106326,9593,9562,19155,2751,2813,5564
2106359,4390,3661,8051,1252,1033,2285
2106375,7168,6897,14065,2253,2075,4328
2106409,7591,7559,15150,2211,2207,4418
2106508,11027,10858,21885,3315,3134,6449
2106607,15583,15432,31015,4167,4070,8237
2106631,7241,6553,13794,2092,1901,3993
2106672,4196,3922,8118,1149,1084,2233
2106706,10456,9996,20452,3014,2661,5675
2106755,11809,12618,24427,3600,4134,7734
2106805,7287,6931,14218,2023,1975,3998
2106904,16191,15547,31738,4662,4366,9028
2107001,4904,4509,9413,1285,1207,2492
2107100,9152,8631,17783,2666,2476,5142
2107209,6336,6128,12464,1843,1787,3630
2107258,2600,2285,4885,736,603,1339
2107308,2331,2259,4590,651,603,1254
2107357,9581,9553,19134,2834,2924,5758
2107407,9185,9416,18601,2625,2690,5315
2107456,6805,6376,13181,2125,1976,4101
2107506,50910,54211,105121,15918,16877,32795
2107605,9388,9376,18764,2902,2779,5681
2107704,9878,10225,20103,2930,2772,5702
2107803,17524,17062,34586,4813,4586,9399
2107902,8693,8869,17562,2380,2365,4745
2108009,9179,8888,18067,2650,2362,5012
2108058,7502,7017,14519,2196,2036,4232
2108108,10128,9951,20079,2952,2854,5806
2108207,18860,20588,39448,5333,5640,10973
2108256,11836,10896,22732,3387,3065,6452
2108306,17403,16864,34267,5230,4798,10028
2108405,6989,6814,13803,1991,2014,4005
2108454,10569,10632,21201,2902,2873,5775
2108504,15243,15909,31152,4525,4492,9017
2108603,38079,40083,78162,11334,12012,23346
2108702,11004,11012,22016,3133,3104,6237
2108801,8666,8715,17381,2538.215,2408.246,4946.461
2108900,9919,9789,19708,2864,2729,5593
2109007,10848,10682,21530,3199,3135,6334
2109056,3194,2836,6030,823,769,1592
2109106,21966,22765,44731,6566,6725,13291
2109205,6004,5537,11541,1796,1629,3425
2109239,3294,3080,6374,980,878,1858
2109270,8893,8272,17165,2563,2426,4989
2109304,5460,5257,10717,1564,1430,2994
2109403,7410,6544,13954,2028,1817,3845
2109452,13121,13206,26327,3967,4135,8102
2109502,10390,9819,20209,2635,2524,5159
2109551,3771,3547,7318,1054,1023,2077
2109601,19658,19918,39576,6131,6074,12205
2109700,2894,2593,5487,817,644,1461
2109759,3670,3391,7061,1087,909,1996
2109809,19425,19685,39110,5895,5917,11812
2109908,36887,40395,77282,10430,11593,22023
2110005,37699,36344,74043,10434,10260,20694
2110039,11377,11267,22644,3577,3482,7059
2110104,14736,14455,29191,4240,4035,8275
2110203,16326,16040,32366,5085,4930,10015
2110237,6028,5633,11661,1809,1692,3501
2110278,7314,6506,13820,2282,1899,4181
2110302,7190,7098,14288,1982,2001,3983
2110401,9040,8759,17799,2485,2428,4913
2110500,19944,20792,40736,6099,6498,12597
2110609,13356,13120,26476,3864,3822,7686
2110658,3566,3417,6983,986,928,1914
2110708,16904,16703,33607,4665,4644,9309
2110807,2454,2248,4702,694,570,1264
2110856,5268,4993,10261,1440,1382,2822
2110906,6152,5994,12146,1662,1553,3215
2111003,10131,9789,19920,2931,2784,5715
2111029,6339,5970,12309,1783,1732,3515
2111052,5777,5037,10814,1608,1370,2978
2111078,8816,8422,17238,2259,2083,4342
2111102,12210,12718,24928,3356,3436,6792
2111201,78683,84362,163045,24534,26877,51411
2111250,3757,3739,7496,1090,996,2086
2111300,474995,539842,1014837,151187,169592,320779
2111409,10161,9992,20153,2787,2684,5471
2111508,19231,19862,39093,5347,5453,10800
2111532,6115,5913,12028,1735,1704,3439
2111573,2355,2070,4425,719,613,1332
2111607,8884,8590,17474,2570,2462,5032
2111631,3186,2904,6090,962,853,1815
2111672,3091,2866,5957,926,900,1826
2111706,10580,10283,20863,3309,3092,6401
2111722,6170,5820,11990,1809,1680,3489
2111748,5122,5134,10256,1462,1445,2907
2111763,9060,8938,17998,2461,2419,4880
2111789,5851,5089,10940,1604,1333,2937
2111805,8942,8060,17002,2556,2251,4807
2111904,5337,5107,10444,1561,1301,2862
2111953,2372,2241,4613,597,583,1180
2112001,3973,3823,7796,1173,1062,2235
2112100,14092,13905,27997,4157,3861,8018
2112209,75561,79899,155460,22414,22901,45315
2112233,9141,9812,18953,2624,2746,5370
2112274,2857,2739,5596,740,682,1422
2112308,19992,19191,39183,5654,5403,11057
2112407,17626,16307,33933,5200,4626,9826
2112456,11481,11365,22846,3297,3352,6649
2112506,26680,26108,52788,7918,7918,15836
2112605,12372,12201,24573,3743,3716,7459
2112704,24619,24793,49412,7297,7494,14791
2112803,24712,24784,49496,7310,7169,14479
2112852,5938,5320,11258,1743,1585,3328
2112902,15564,15653,31217,4576,4462,9038
2113009,15721,15937,31658,4337,4230,8567
2114007,24898,25275,50173,7278,7346,14624
2200053,3459,3290,6749,947,886,1833
2200103,2455,2643,5098,635,648,1283
2200202,7804,8647,16451,2010,2202,4212
2200251,3683,3658,7341,978,979,1957
2200277,2556,2597,5153,713,691,1404
2200301,6958,6688,13646,1831,1706,3537
2200400,19116,19706,38822,5439,5439,10878
2200459,2648,2402,5050,749,647,1396
2200509,8317,8818,17135,2158,2241,4399
2200608,3235,3437,6672,778,803,1581
2200707,4642,4456,9098,1291,1283,2574
2200806,1558,1481,3039,445,386,831
2200905,2863,2916,5779,723,690,1413
2200954,1273,1167,2440,347,280,627
2201002,2316,2372,4688,624,623,1247
2201051,3825,3678,7503,991,933,1924
2201101,5581,5486,11067,1376,1429,2805
2201150,5468,5048,10516,1667,1569,3236
2201176,1821,2031,3852,474,516,990
2201200,22566,22284,44850,6558,6381,12939
2201309,1690,1544,3234,452,399,851
2201408,3230,3377,6607,888,891,1779
2201507,13048,12726,25774,3666,3526,7192
2201556,1936,1842,3778,517,464,981
2201572,1682,1602,3284,441,427,868
2201606,5014,4897,9911,1439,1301,2740
2201705,2679,2640,5319,751,693,1444
2201739,3113,2902,6015,864,770,1634
2201770,3204,3092,6296,886,908,1794
2201804,2149,2220,4369,485,526,1011
2201903,11303,11326,22629,3532,3594,7126
2201919,2747,2557,5304,742,701,1443
2201929,2693,2700,5393,743,743,1486
2201945,3079,3114,6193,844,826,1670
2201960,4075,3891,7966,1132,1077,2209
2201988,1944,1906,3850,499,469,968
2202000,9622,9452,19074,2839,2716,5555
2202026,4145,3829,7974,1142,1011,2153
2202059,5094,4834,9928,1436,1359,2795
2202075,1698,1645,3343,479,448,927
2202083,3742,3421,7163,1012.495,903.8202,1916.315
2202091,2845,2826,5671,712,731,1443
2202109,2710,2698,5408,655,676,1331
2202117,2404,2289,4693,690,671,1361
2202133,2839,2753,5592,828,731,1559
2202174,3466,3337,6803,1032,987,2019
2202208,21781,23396,45177,6023,6135,12158
2202251,2029,1892,3921,521,472,993
2202307,9954,10066,20020,2672,2588,5260
2202406,5438,5515,10953,1489,1536,3025
2202455,1999,1879,3878,493,500,993
2202505,5202,5010,10212,1509,1463,2972
2202539,2837,2688,5525,773,736,1509
2202554,2500,2326,4826,761,668,1429
2202604,8982,9354,18336,2363,2365,4728
2202653,2656,2383,5039,792,669,1461
2202703,13165,12871,26036,3719,3620,7339
2202711,2207,2318,4525,560,620,1180
2202729,2797,2775,5572,786,779,1565
2202737,1970,1841,3811,523,507,1030
2202752,2963,3073,6036,798,863,1661
2202778,3701,3732,7433,1077,1020,2097
2202802,2247,2228,4475,536,568,1104
2202851,2378,2163,4541,651,549,1200
2202901,12844,12563,25407,3660,3678,7338
2203008,4087,3744,7831,1105,1007,2112
2203107,5036,4945,9981,1504,1390,2894
2203206,5455,5306,10761,1496,1421,2917
2203230,2473,2231,4704,686,589,1275
2203255,2144,2039,4183,624,566,1190
2203271,2531,2338,4869,719,632,1351
2203305,6477,6801,13278,1854,1821,3675
2203354,3403,3272,6675,955,833,1788
2203404,3221,3348,6569,851,876,1727
2203420,2156,2108,4264,590,535,1125
2203453,4733,4512,9245,1221,1147,2368
2203503,7148,7364,14512,1892,1869,3761
2203602,2402,2263,4665,637,561,1198
2203701,18776,18991,37767,5722,5518,11240
2203750,2574,2500,5074,690.2852,627.2767,1317.562
2203800,2219,2147,4366,584,526,1110
2203859,1272,1210,2482,292,297,589
2203909,27309,30381,57690,8154,8808,16962
2204006,2558,2677,5235,654,669,1323
2204105,2221,2256,4477,582,570,1152
2204154,1436,1443,2879,427,383,810
2204204,4383,4209,8592,1197,1100,2297
2204303,5478,5639,11117,1464,1457,2921
2204352,2776,2699,5475,753,684,1437
2204402,5213,5189,10402,1531,1456,2987
2204501,5088,5180,10268,1455,1461,2916
2204550,2216,2185,4401,700,670,1370
2204600,1839,1932,3771,463,512,975
2204659,4557,4357,8914,1264,1129,2393
2204709,7319,7526,14845,1911,1914,3825
2204808,4595,4732,9327,1242,1211,2453
2204907,4120,4101,8221,1210,1106,2316
2205003,5545,5564,11109,1330,1318,2648
2205102,5385,5293,10678,1464,1353,2817
2205151,2904,2818,5722,826,801,1627
2205201,8800,9235,18035,2386,2422,4808
2205250,2182,2127,4309,577,546,1123
2205276,2423,2233,4656,590,545,1135
2205300,2221,2169,4390,613,529,1142
2205359,1571,1389,2960,462,378,840
2205409,7154,6663,13817,2133,1942,4075
2205458,2665,2435,5100,859,757,1616
2205508,18522,18563,37085,5473,5419,10892
2205516,2419,2338,4757,646,617,1263
2205524,2800,2573,5373,774,708,1482
2205532,2354,2163,4517,649,630,1279
2205540,1339,1317,2656,316,360,676
2205557,4124,3884,8008,1167,1079,2246
2205565,2321,2202,4523,667,625,1292
2205573,3208,3214,6422,882,805,1687
2205581,1990,1873,3863,573,530,1103
2205599,2463,2387,4850,592,573,1165
2205607,2619,2662,5281,586,637,1223
2205706,14593,13813,28406,4268,4019,8287
2205805,12405,12316,24721,3643,3589,7232
2205854,4044,3772,7816,1269,1159,2428
2205904,2701,2512,5213,785,682,1467
2205953,3867,3945,7812,1106,1107,2213
2206001,2219,2237,4456,564,569,1133
2206050,3152,3068,6220,847,773,1620
2206100,5266,5207,10473,1541,1491,3032
2206209,16359,15930,32289,4739,4468,9207
2206308,657,596,1253,178,160,338
2206357,3441,3328,6769,940,876,1816
2206407,5105,5228,10333,1448,1440,2888
2206506,3715,3676,7391,1011,957,1968
2206605,5285,5060,10345,1592,1423,3015
2206654,2061,2007,4068,543,541,1084
2206670,3323,3176,6499,1012,929,1941
2206696,4422,4042,8464,1272,1142,2414
2206704,3667,3654,7321,948,923,1871
2206720,4085,3983,8068,1157,1068,2225
2206753,2331,2225,4556,622,561,1183
2206803,4077,4129,8206,1217,1192,2409
2206902,3234,3264,6498,885,796,1681
2206951,1672,1588,3260,421,393,814
2207009,17041,18599,35640,4669,5028,9697
2207108,1308,1318,2626,293,325,618
2207207,3229,3428,6657,811,847,1658
2207306,2048,2011,4059,560,533,1093
2207355,1744,1619,3363,361,377,738
2207405,2571,2422,4993,708,641,1349
2207504,6781,6964,13745,1874,1777,3651
2207553,2143,2004,4147,530,466,996
2207603,5459,4817,10276,1592,1377,2969
2207702,69727,75978,145705,20096,21392,41488
2207751,2316,2230,4546,702,643,1345
2207777,3093,3012,6105,754,745,1499
2207793,1935,1822,3757,480,446,926
2207801,9567,10218,19785,2566,2820,5386
2207850,1950,1713,3663,559,426,985
2207900,18443,19053,37496,4806,4927,9733
2207934,1251,1156,2407,328,300,628
2207959,2152,2035,4187,568,524,1092
2208007,35061,38353,73414,10197,10757,20954
2208106,5998,5735,11733,1513,1487,3000
2208205,8820,8851,17671,2464,2397,4861
2208304,13628,13925,27553,3968,3834,7802
2208403,30138,31696,61834,8309,8483,16792
2208502,6009,5888,11897,1817,1684,3501
2208551,1324,1235,2559,388,319,707
2208601,1551,1534,3085,406,398,804
2208650,4280,4273,8553,1233,1137,2370
2208700,4223,4177,8400,1214,1233,2447
2208809,8590,8966,17556,2417,2459,4876
2208858,2220,2021,4241,631,571,1202
2208874,2138,2125,4263,575,552,1127
2208908,3511,3334,6845,1086,944,2030
2209005,3113,3160,6273,822,792,1614
2209104,2973,3054,6027,781,738,1519
2209153,1884,1910,3794,488,491,979
2209203,3217,2879,6096,962,791,1753
2209302,2868,2645,5513,786,719,1505
2209351,2399,2518,4917,626,630,1256
2209377,2582,2567,5149,661,635,1296
2209401,2976,3031,6007,737,756,1493
2209450,1023,1036,2059,272,281,553
2209500,1851,1797,3648,458,418,876
2209559,2240,2073,4313,621,547,1168
2209609,1500,1569,3069,332,386,718
2209658,2832,2735,5567,757,745,1502
2209708,3190,3108,6298,831,720,1551
2209757,1464,1361,2825,421,345,766
2209807,2353,2401,4754,622,629,1251
2209856,2188,2257,4445,497,544,1041
2209872,2805,2803,5608,730,721,1451
2209906,3012,3145,6157,741,721,1462
2209955,2284,2367,4651,624,627,1251
2209971,3695,3641,7336,1042,1064,2106
2210003,9584,9964,19548,2711,2831,5542
2210052,2653,2495,5148,827,753,1580
2210102,1885,1815,3700,434,427,861
2210201,3281,3310,6591,852,807,1659
2210300,2829,2846,5675,724,722,1446
2210359,2266,2161,4427,583,562,1145
2210375,1262,1299,2561,300,301,601
2210383,1050,1060,2110,260,280,540
2210391,1546,1430,2976,394,329,723
2210409,9219,8915,18134,2490,2305,4795
2210508,6822,6817,13639,1852,1765,3617
2210607,15897,16430,32327,4482,4751,9233
2210623,1889,1671,3560,501,439,940
2210631,2151,1965,4116,561.8667,522,1083.867
2210656,4972,4647,9619,1233,1226,2459
2210706,7078,7102,14180,1869,1910,3779
2210805,6090,5987,12077,1611,1609,3220
2210904,2301,2221,4522,632,546,1178
2210938,3099,3130,6229,760,794,1554
2210953,1443,1310,2753,390,336,726
2210979,1276,1344,2620,348,341,689
2211001,380612,433618,814230,116871.8,129121.8,245993.6
2211100,21404,21250,42654,6189,5936,12125
2211209,9909,10240,20149,2939,2935,5874
2211308,9577,10749,20326,2393,2705,5098
2211357,2498,2415,4913,688,673,1361
2211407,2048,2288,4336,516,565,1081
2211506,1492,1494,2986,364,365,729
2211605,1576,1500,3076,379,385,764
2211704,2165,2115,4280,569,507,1076
2300101,5210,5286,10496,1477,1406,2883
2300150,7571,7767,15338,2253,2147,4400
2300200,29102,28449,57551,8849,8369,17218
2300309,25624,25536,51160,6527,6488,13015
2300408,8117,8086,16203,2190,2151,4341
2300507,5314,5457,10771,1538,1568,3106
2300606,3317,3539,6856,826,876,1702
2300705,8217,8142,16359,2286,2304,4590
2300754,20356,18876,39232,6053,5438,11491
2300804,3344,3640,6984,797,918,1715
2300903,7072,6853,13925,1906,1850,3756
2301000,37130,35498,72628,11163,10382,21545
2301109,34147,35012,69159,9920,9903,19823
2301208,12788,12603,25391,3690,3399,7089
2301257,5180,5311,10491,1352,1248,2600
2301307,10292,10393,20685,2865,2858,5723
2301406,5823,5706,11529,1705,1653,3358
2301505,3850,3800,7650,1047,957,2004
2301604,11080,11365,22445,2943,2778,5721
2301703,12224,12342,24566,3288,3221,6509
2301802,3055,2971,6026,814,790,1604
2301851,8737,8578,17315,2392,2360,4752
2301901,26904,28419,55323,8059,8085,16144
2301950,9736,9837,19573,2802,2771,5573
2302008,10627,10887,21514,2914,2824,5738
2302057,7321,7155,14476,2092,1953,4045
2302107,16396,16925,33321,4562,4595,9157
2302206,24857,24454,49311,6857,6599,13456
2302305,15701,15177,30878,4525,4370,8895
2302404,26340,26158,52498,6983,6613,13596
2302503,21918,23275,45193,6584,6827,13411
2302602,29770,30388,60158,8780,8734,17514
2302701,12706,13800,26506,3409,3601,7010
2302800,36912,37561,74473,10401,10430,20831
2302909,8638,8424,17062,2524,2440,4964
2303006,10124,9896,20020,2891,2748,5639
2303105,9142,9205,18347,2486,2339,4825
2303204,12812,13581,26393,3343,3500,6843
2303303,9334,9233,18567,2539,2283,4822
2303402,8347,8399,16746,2149,2180,4329
2303501,32887,33255,66142,9431,9227,18658
2303600,9302,9443,18745,2665,2912,5577
2303659,5033,4919,9952,1275,1198,2473
2303709,159598,165843,325441,48474,48339,96813
2303808,12108,12419,24527,3083,3010,6093
2303907,6194,6421,12615,1757,1802,3559
2303931,6586,6267,12853,1849,1779,3628
2303956,9600,9315,18915,2903,2789,5692
2304004,10944,11010,21954,3154,3003,6157
2304103,35509,37303,72812,9325,9320,18645
2304202,57616,63812,121428,16844,17908,34752
2304236,8328,8741,17069,2124,2263,4387
2304251,11091,11388,22479,2941,3272,6213
2304269,4562,4533,9095,1046,1115,2161
2304277,3428,3412,6840,1004,886,1890
2304285,22951,23082,46033,6814,7025,13839
2304301,9329,9678,19007,2596,2589,5185
2304350,10786,11000,21786,3176,3141,6317
2304400,1147918,1304267,2452185,344942,373671,718613
2304459,7456,7361,14817,2175,2024,4199
2304509,6378,6613,12991,1779,1801,3580
2304608,3164,3054,6218,865,835,1700
2304657,7439,7610,15049,1875,1871,3746
2304707,26714,25931,52645,7612,7039,14651
2304806,2263,2366,4629,614,646,1260
2304905,5045,5183,10228,1439,1360,2799
2304954,12139,11952,24091,3754,3496,7250
2305001,18660,19115,37775,4905,4958,9863
2305100,2099,2065,4164,628,566,1194
2305209,9626,9699,19325,2382,2341,4723
2305233,27532,27655,55187,9214,9060,18274
2305266,6667,6255,12922,1845,1663,3508
2305308,11933,11875,23808,3329,3207,6536
2305332,5865,5470,11335,1785,1563,3348
2305357,9414,8978,18392,2667,2571,5238
2305407,31881,33575,65456,8783,9068,17851
2305506,46425,50070,96495,12707,13653,26360
2305605,12741,12832,25573,3269,3161,6430
2305654,5658,5685,11343,1334,1267,2601
2305704,5996,6013,12009,1622,1536,3158
2305803,19956,20340,40296,5445,5240,10685
2305902,18533,19329,37862,4607,4767,9374
2306009,6763,6959,13722,1894,1828,3722
2306108,11347,10977,22324,3297,3114,6411
2306207,3642,3674,7316,1048,995,2043
2306256,18288,17529,35817,5972,5261,11233
2306306,23990,24360,48350,7012,6973,13985
2306405,58243,57822,116065,17215,16974,34189
2306504,9461,9165,18626,2719,2594,5313
2306553,19351,18120,37471,6002,5459,11461
2306603,9589,9305,18894,2647,2572,5219
2306702,9071,8792,17863,2430,2255,4685
2306801,5277,5122,10399,1430,1434,2864
2306900,16829,17580,34409,4409,4424,8833
2307007,16076,16160,32236,4816,4688,9504
2307106,13067,13621,26688,3639,3808,7447
2307205,3830,3830,7660,1061,1045,2106
2307254,8520,8482,17002,2578,2688,5266
2307304,118353,131586,249939,35207,37294,72501
2307403,11766,12041,23807,2972,3069,6041
2307502,15568,15522,31090,4167,4009,8176
2307601,27577,28687,56264,7664,7657,15321
2307635,9083,9005,18088,2512,2383,4895
2307650,102078,106979,209057,31723,32448,64171
2307700,56619,56942,113561,17476,17226,34702
2307809,12599,12104,24703,3774,3596,7370
2307908,5100,5114,10214,1488,1386,2874
2308005,17444,17747,35191,5263,5079,10342
2308104,22091,22149,44240,6305,6126,12431
2308203,6874,6819,13693,2062,1936,3998
2308302,13926,14390,28316,3960,3823,7783
2308351,6528,6558,13086,1585,1575,3160
2308377,6607,6193,12800,1853,1668,3521
2308401,16915,17359,34274,4806,4786,9592
2308500,21249,21441,42690,5708,5499,11207
2308609,8295,8410,16705,2125,2159,4284
2308708,31143,30922,62065,8534,8071,16605
2308807,4070,4000,8070,1196,1134,2330
2308906,10440,10260,20700,2992,2891,5883
2309003,6699,7403,14102,1637,1851,3488
2309102,5842,5643,11485,1614,1471,3085
2309201,7020,7236,14256,2106,2072,4178
2309300,15024,15941,30965,3869,3946,7815
2309409,13549,13904,27453,3546,3448,6994
2309458,12317,11690,24007,3475,3183,6658
2309508,10421,10968,21389,2643,2602,5245
2309607,30370,31468,61838,9289,9425,18714
2309706,35599,36700,72299,10720,11273,21993
2309805,5850,5757,11607,1672,1565,3237
2309904,2902,3084,5986,783,781,1564
2310001,4470,4396,8866,1335,1182,2517
2310100,6002,6003,12005,1726,1679,3405
2310209,15852,15784,31636,4408.349,4428.168,8836.518
2310258,15291,14750,30041,4365,4107,8472
2310308,15262,16047,31309,3825,4090,7915
2310407,5814,5494,11308,1569,1442,3011
2310506,20697,21193,41890,5624,5643,11267
2310605,4044,4182,8226,1175,1153,2328
2310704,17899,17501,35400,5021,4768,9789
2310803,7762,7995,15757,2080,2071,4151
2310852,9340,9343,18683,2604,2594,5198
2310902,7790,7677,15467,2064,1962,4026
2310951,5139,5077,10216,1322,1275,2597
2311009,5974,6027,12001,1568,1524,3092
2311108,7366,7695,15061,2154,2121,4275
2311207,4987,5289,10276,1277,1388,2665
2311231,3159,2967,6126,862,810,1672
2311264,9852,10069,19921,2551,2556,5107
2311306,39769,40835,80604,11559,11583,23142
2311355,7549,7451,15000,1814,1796,3610
2311405,35729,36158,71887,10076,10012,20088
2311504,9706,9706,19412,2898,2811,5709
2311603,13122,13293,26415,3650,3543,7193
2311702,9681,9774,19455,2515,2405,4920
2311801,34405,35428,69833,10415,10187,20602
2311900,7762,7990,15752,1951,2027,3978
2311959,7770,7683,15453,2207,2113,4320
2312007,15171,14775,29946,4419,4125,8544
2312106,8640,8530,17170,2382,2273,4655
2312205,21441,21322,42763,5928,5586,11514
2312304,21829,22349,44178,6026,5990,12016
2312403,22348,21542,43890,6768,6222,12990
2312502,3852,4048,7900,929,889,1818
2312601,6142,6190,12332,1801,1667,3468
2312700,13019,13450,26469,3412,3384,6796
2312809,3431,3421,6852,980,939,1919
2312908,91462,96771,188233,29206,29914,59120
2313005,8838,8827,17665,2222,2146,4368
2313104,14214,14990,29204,3803,3868,7671
2313203,12631,12820,25451,3409,3234,6643
2313252,4452,4458,8910,1199,1210,2409
2313302,27357,28359,55716,7019,7224,14243
2313351,8608,8219,16827,2543,2385,4928
2313401,34175,34717,68892,10200,10314,20514
2313500,26437,24985,51422,7732,7110,14842
2313559,7473,6935,14408,2251,1950,4201
2313609,15760,16027,31787,4502,4536,9038
2313708,3772,3773,7545,976,889,1865
2313757,9641,9161,18802,2878,2654,5532
2313807,9925,9840,19765,3093,2898,5991
2313906,6498,6385,12883,1857,1764,3621
2313955,8705,8888,17593,2326,2341,4667
2314003,18660,19774,38434,4940,5098,10038
2314102,27663,27292,54955,8130,7903,16033
2400109,5364,5671,11035,1454,1434,2888
2400208,26141,27086,53227,7514,7461,14975
2400307,5451,5393,10844,1515,1464,2979
2400406,1480,1500,2980,460,438,898
2400505,6616,6891,13507,1705,1658,3363
2400604,2497,2374,4871,708,587,1295
2400703,6165,6140,12305,1750,1770,3520
2400802,5656,5893,11549,1649,1630,3279
2400901,3494,3413,6907,879,835,1714
2401008,17376,17387,34763,4953,4855,9808
2401107,12345,12970,25315,3399,3325,6724
2401206,6410,6514,12924,1900,1865,3765
2401305,4708,4581,9289,1316,1232,2548
2401404,4333,4240,8573,1195,1139,2334
2401453,12271,11911,24182,3657,3340,6997
2401503,2020,1930,3950,522,465,987
2401602,2630,2483,5113,803,695,1498
2401651,1260,1165,2425,355,320,675
2401701,4708,4732,9440,1294,1238,2532
2401800,5800,5777,11577,1634,1615,3249
2401859,3119,2897,6016,904,782,1686
2401909,1644,1664,3308,493,479,972
2402006,30373,32336,62709,8385,8215,16600
2402105,5104,5162,10266,1387,1398,2785
2402204,15472,15444,30916,4631,4483,9114
2402303,9568,10008,19576,2561,2536,5097
2402402,3716,3713,7429,1020,974,1994
2402501,4896,4866,9762,1398,1357,2755
2402600,33747,34394,68141,10001,9739,19740
2402709,5459,5457,10916,1584,1443,3027
2402808,2747,2658,5405,799,680,1479
2402907,2368,2404,4772,649,611,1260
2403004,3906,4061,7967,1030,1046,2076
2403103,20373,22279,42652,5519,5609,11128
2403202,3193,3299,6492,904,881,1785
2403251,96995,105461,202456,28378,30705,59083
2403301,2565,2666,5231,684,706,1390
2403400,2960,2862,5822,859,759,1618
2403509,5319,5156,10475,1510,1337,2847
2403608,12195,12374,24569,3513,3499,7012
2403707,2869,2865,5734,770,698,1468
2403756,1456,1398,2854,436,390,826
2403806,4492,4467,8959,1253,1153,2406
2403905,1457,1417,2874,395,359,754
2404002,2072,2161,4233,573,549,1122
2404101,1115,1044,2159,358.9819,288.1346,647.1165
2404200,11202,11279,22481,3287,3315,6602
2404309,6318,6056,12374,1802,1644,3446
2404408,4762,4631,9393,1343,1278,2621
2404507,6223,6181,12404,1885,1807,3692
2404606,6276,5895,12171,1780,1648,3428
2404705,7002,6854,13856,2031,1987,4018
2404804,1038,1039,2077,256,260,516
2404853,3543,3389,6932,1059,985,2044
2404903,2741,2823,5564,722,721,1443
2405009,3935,3990,7925,1117,1070,2187
2405108,3514,3287,6801,992,932,1924
2405207,2650,2695,5345,756,647,1403
2405306,4637,4374,9011,1289,1195,2484
2405405,2806,2716,5522,828,706,1534
2405504,1353,1254,2607,353,356,709
2405603,6724,6782,13506,1883,1879,3762
2405702,5886,6227,12113,1477,1428,2905
2405801,16042,16185,32227,4705,4638,9343
2405900,1281,1320,2601,389,368,757
2406007,2822,3046,5868,713,714,1427
2406106,8869,8823,17692,2423,2347,4770
2406155,1878,1704,3582,523,459,982
2406205,3132,3095,6227,949,862,1811
2406304,3565,3424,6989,1010,898,1908
2406403,1367,1301,2668,408,346,754
2406502,6924,7059,13983,2011,2025,4036
2406601,3800,3764,7564,1114,1057,2171
2406700,5164,5217,10381,1407,1356,2763
2406809,2348,2264,4612,659,622,1281
2406908,1829,1804,3633,511,479,990
2407005,4723,4887,9610,1355,1312,2667
2407104,34434,35033,69467,10031,9970,20001
2407203,14182,14772,28954,3704.011,3673.998,7378.009
2407252,1749,1787,3536,433,462,895
2407302,4064,4201,8265,1118,1093,2211
2407401,4043,4175,8218,1081,978,2059
2407500,5350,5091,10441,1521,1418,2939
2407609,2119,2069,4188,567,526,1093
2407708,5665,5748,11413,1577,1506,3083
2407807,10275,10410,20685,2919,2928,5847
2407906,1154,1107,2261,318,322,640
2408003,125747,134068,259815,37175,38167,75342
2408102,377947,425792,803739,112683,118923,231606
2408201,12288,11496,23784,3582,3095,6677
2408300,17499,17991,35490,5020,4973,9993
2408409,2211,2084,4295,561,478,1039
2408508,2354,2345,4699,627,530,1157
2408607,2041,1911,3952,549,485,1034
2408706,1925,1934,3859,510.1638,540.1475,1050.311
2408805,2434,2411,4845,709,662,1371
2408904,9961,10393,20354,2835,2744,5579
2408953,5134,4925,10059,1422,1340,2762
2409100,5508,5592,11100,1594,1650,3244
2409209,1454,1441,2895,379,384,763
2409308,5886,6078,11964,1591,1484,3075
2409332,2419,2343,4762,712,638,1350
2409407,13516,14229,27745,3889,3852,7741
2409506,1772,1749,3521,550,497,1047
2409605,1340,1250,2590,391,332,723
2409704,3691,3480,7171,1045,896,1941
2409803,7160,6954,14114,2045,1904,3949
2409902,6693,6739,13432,1888,1778,3666
2410009,1729,1724,3453,483,462,945
2410108,7057,6892,13949,2166,2045,4211
2410207,3585,3735,7320,985,963,1948
2410256,2730,2487,5217,764,674,1438
2410306,4471,4297,8768,1277,1185,2462
2410405,4277,4147,8424,1197,1105,2302
2410504,2328,2364,4692,606,605,1211
2410603,1537,1526,3063,361,325,686
2410702,1617,1548,3165,480,412,892
2410801,2073,2083,4156,533,530,1063
2410900,3560,3507,7067,1000,961,1961
2411007,2173,2245,4418,563,566,1129
2411056,1847,1840,3687,516,526,1042
2411106,1835,1760,3595,510,471,981
2411205,17472,18325,35797,5308,5290,10598
2411403,6869,6940,13809,1881,1814,3695
2411429,1267,1259,2526,361,356,717
2411502,11099,11117,22216,3178,3047,6225
2411601,1524,1451,2975,431,391,822
2411700,1940,1965,3905,584,540,1124
2411809,1737,1664,3401,468,432,900
2411908,1945,1929,3874,546,511,1057
2412005,43179,44489,87668,12768,12852,25620
2412104,2923,2999,5922,828,722,1550
2412203,19844,19932,39776,5637,5535,11172
2412302,6150,6206,12356,1803,1689,3492
2412401,2122,2109,4231,616,603,1219
2412500,10572,11585,22157,2797,3029,5826
2412559,4474,4196,8670,1398,1269,2667
2412609,7824,8019,15843,2247,2188,4435
2412708,3172,3063,6235,864,774,1638
2412807,4130,3981,8111,1102,1013,2115
2412906,5436,5391,10827,1424,1353,2777
2413003,2944,3084,6028,789,794,1583
2413102,2860,2777,5637,779,708,1487
2413201,1944,1980,3924,566,554,1120
2413300,2865,2878,5743,843,791,1634
2413359,5392,4895,10287,1551,1394,2945
2413409,3901,3869,7770,1066,987,2053
2413508,3452,3129,6581,974,803,1777
2413557,2293,2247,4540,579,589,1168
2413607,2865,2887,5752,776,754,1530
2413706,2542,2478,5020,771,694,1465
2413805,1178,1139,2317,324,307,631
2413904,6112,5724,11836,1853,1602,3455
2414001,7159,7016,14175,2145,1949,4094
2414100,4979,4904,9883,1454,1380,2834
2414159,2746,2660,5406,755,768,1523
2414209,5758,5627,11385,1689,1656,3345
2414308,1145,1150,2295,318,282,600
2414407,16068,15021,31089,4810,4262,9072
2414456,1770,1598,3368,522,445,967
2414506,5228,5431,10659,1406,1386,2792
2414605,6719,6273,12992,1960,1708,3668
2414704,2622,2614,5236,717,705,1422
2414753,1952,1869,3821,592,541,1133
2414803,5355,5364,10719,1476,1480,2956
2414902,806,812,1618,213,227,440
2415008,1460,1412,2872,427,452,879
2500106,4719,4730,9449,1353,1254,2607
2500205,2706,2824,5530,642,694,1336
2500304,13861,14618,28479,3749,3724,7473
2500403,9761,9920,19681,2700,2685,5385
2500502,6704,6872,13576,1927,1836,3763
2500536,2624,2615,5239,695,659,1354
2500577,1217,1149,2366,334,315,649
2500601,8864,9143,18007,2497,2600,5097
2500700,8940,9261,18201,2257,2316,4573
2500734,1047,1041,2088,294,279,573
2500775,3796,3880,7676,961,967,1928
2500809,8574,8650,17224,2289,2191,4480
2500908,6074,6579,12653,1576,1566,3142
2501005,9324,9555,18879,2518,2495,5013
2501104,11669,12160,23829,3443,3322,6765
2501153,963,964,1927,298,276,574
2501203,3058,3412,6470,810,869,1679
2501302,9222,9860,19082,2299,2456,4755
2501351,1779,1743,3522,503,506,1009
2501401,4040,3972,8012,1138,1119,2257
2501500,10784,11067,21851,2850,2842,5692
2501534,2110,2110,4220,549,531,1080
2501575,4147,4059,8206,1071,1011,2082
2501609,7085,7072,14157,1888,1753,3641
2501708,2918,2693,5611,814,701,1515
2501807,47736,51980,99716,13655,14155,27810
2501906,8345,8748,17093,2316.375,2125.867,4442.242
2502003,3607,3536,7143,981,882,1863
2502052,1476,1599,3075,368,432,800
2502102,2899,2852,5751,875,798,1673
2502151,3085,3142,6227,881,855,1736
2502201,1219,1181,2400,330,283,613
2502300,2477,2558,5035,592,557,1149
2502409,5350,5454,10804,1518,1538,3056
2502508,8323,8565,16888,2390,2359,4749
2502607,3019,3137,6156,774,818,1592
2502706,2558,2553,5111,666,653,1319
2502805,6510,6613,13123,1918,1786,3704
2502904,3094,3104,6198,807,740,1547
2503001,10090,10272,20362,2972,2981,5953
2503100,2493,2542,5035,659,638,1297
2503209,27630,30314,57944,7735,8265,16000
2503308,4820,4726,9546,1410,1269,2679
2503407,1779,1778,3557,518,508,1026
2503506,8217,8531,16748,2201,2179,4380
2503555,3284,3530,6814,878,939,1817
2503605,3619,3601,7220,1033,874,1907
2503704,27938,30508,58446,8054,8408,16462
2503753,1548,1485,3033,427,406,833
2503803,2802,2835,5637,757,754,1511
2503902,2840,2909,5749,695,675,1370
2504009,182205,203008,385213,52735,54916,107651
2504033,2815,2786,5601,778,743,1521
2504074,1972,1927,3899,469,458,927
2504108,1247,1131,2378,358,303,661
2504157,3549,3509,7058,958,930,1888
2504207,2413,2399,4812,667,643,1310
2504306,14028,14731,28759,3914,3914,7828
2504355,2300,2243,4543,614,569,1183
2504405,9120,9243,18363,2624,2484,5108
2504504,3215,3369,6584,805,775,1580
2504603,10763,10637,21400,3117,3121,6238
2504702,2378,2309,4687,534.8,549,1083.8
2504801,7421,7728,15149,1962,1967,3929
2504850,916,855,1771,254,203,457
2504900,8093,8164,16257,2229,2229,4458
2505006,3393,3473,6866,917,932,1849
2505105,9833,10145,19978,2640,2605,5245
2505204,3389,3500,6889,960,902,1862
2505238,3100,3102,6202,796,823,1619
2505279,2632,2577,5209,694,663,1357
2505303,1304,1201,2505,393,356,749
2505352,2460,2440,4900,691,627,1318
2505402,3893,4098,7991,1046,1042,2088
2505501,1821,1691,3512,539,452,991
2505600,3331,3285,6616,1036,905,1941
2505709,5277,5240,10517,1419,1325,2744
2505808,1790,1848,3638,506,426,932
2505907,1673,1644,3317,461,455,916
2506004,15155,15940,31095,4066,4088,8154
2506103,5607,5798,11405,1514,1489,3003
2506202,1468,1465,2933,355,356,711
2506251,4133,4243,8376,1149,1130,2279
2506301,26693,28633,55326,7560,7705,15265
2506400,6920,6952,13872,1901,1769,3670
2506509,1550,1609,3159,412,394,806
2506608,3033,2998,6031,798,728,1526
2506707,5707,5645,11352,1595,1505,3100
2506806,8838,9342,18180,2339,2323,4662
2506905,11851,12630,24481,3157,3157,6314
2507002,11389,11803,23192,3309,3315,6624
2507101,8560,8437,16997,2381,2255,4636
2507200,5049,5152,10201,1480,1402,2882
2507309,6918,7024,13942,1836,1815,3651
2507408,3694,3844,7538,963,958,1921
2507507,337783,385732,723515,97665.58,105354.9,203020.4
2507606,3641,3818,7459,1014,1001,2015
2507705,8366,8410,16776,2464,2361,4825
2507804,3308,3335,6643,933,919,1852
2507903,5129,5108,10237,1461,1419,2880
2508000,4897,4929,9826,1464,1286,2750
2508109,2304,2377,4681,599,608,1207
2508208,3626,3744,7370,915,928,1843
2508307,12743,13157,25900,3498,3551,7049
2508406,1438,1403,2841,391,386,777
2508505,3524,3640,7164,919,941,1860
2508554,1938,2004,3942,564,549,1113
2508604,5832,5898,11730,1621,1593,3214
2508703,1964,2055,4019,506,534,1040
2508802,2703,2910,5613,698,686,1384
2508901,20790,21513,42303,5967,5851,11818
2509008,5400,5359,10759,1649,1466,3115
2509057,3894,3715,7609,1172,1084,2256
2509107,10367,10809,21176,2751,2668,5419
2509156,3016,3157,6173,786,776,1562
2509206,6245,6657,12902,1647,1711,3358
2509305,3690,3717,7407,1075,1072,2147
2509339,2151,2170,4321,589,576,1165
2509370,1349,1353,2702,387,351,738
2509396,2900,3039,5939,853,830,1683
2509404,6078,6413,12491,1725,1773,3498
2509503,2482,2508,4990,649,644,1293
2509602,2262,2246,4508,658,598,1256
2509701,14985,15867,30852,3846,3985,7831
2509800,4630,4839,9469,1259,1245,2504
2509909,5217,5349,10566,1474,1456,2930
2510006,3631,3649,7280,936,897,1833
2510105,5121,5412,10533,1384,1397,2781
2510204,3019,3051,6070,876,838,1714
2510303,2163,2198,4361,571,531,1102
2510402,3352,3579,6931,949,983,1932
2510501,1853,1774,3627,476,470,946
2510600,1470,1458,2928,379,354,733
2510659,621,635,1256,148.9846,147.3736,296.3582
2510709,1107,1126,2233,317,291,608
2510808,47805,52869,100674,13675,14180,27855
2510907,5829,5959,11788,1602,1581,3183
2511004,1847,1874,3721,540,495,1035
2511103,3734,3741,7475,1010,1015,2025
2511202,13467,13565,27032,3841,3862,7703
2511301,7388,8077,15465,2002,2061,4063
2511400,8953,9269,18222,2416,2292,4708
2511509,5499,5692,11191,1524,1475,2999
2511608,3517,3461,6978,1022,973,1995
2511707,2543,2612,5155,747,733,1480
2511806,5114,5212,10326,1444,1355,2799
2511905,8609,8415,17024,2331.304,2251.379,4582.684
2512002,8490,8542,17032,2304,2142,4446
2512036,1905,1846,3751,585,510,1095
2512077,1933,2045,3978,443,492,935
2512101,15381,16729,32110,4154,4199,8353
2512200,1926,1928,3854,488,491,979
2512309,10448,10835,21283,3043,2996,6039
2512408,6356,6567,12923,1790,1715,3505
2512507,19936,21113,41049,5466,5770,11236
2512606,893,806,1699,245,205,450
2512705,8379,9202,17581,2225,2411,4636
2512721,2890,2875,5765,736,718,1454
2512747,1602,1664,3266,456,464,920
2512754,2082,2182,4264,580,547,1127
2512762,2086,2078,4164,562,537,1099
2512788,871,851,1722,253,224,477
2512804,4242,4072,8314,1235,1168,2403
2512903,11310,11666,22976,3166,3059,6225
2513000,1782,1726,3508,478,437,915
2513109,5836,6140,11976,1464,1481,2945
2513158,3409,3249,6658,918,857,1775
2513208,3283,3188,6471,757,732,1489
2513307,2626,2743,5369,654,637,1291
2513356,1823,1716,3539,560,479,1039
2513406,7138,7581,14719,1888,1900,3788
2513505,2697,2634,5331,749,755,1504
2513604,3512,3754,7266,934,944,1878
2513653,1268,1347,2615,333,373,706
2513703,58119,62191,120310,16064,16630,32694
2513802,2276,2305,4581,524,575,1099
2513851,1337,1301,2638,341,315,656
2513901,15220,15659,30879,4515,4417,8932
2513927,2015,2123,4138,520,552,1072
2513943,1212,1208,2420,290,324,614
2513968,1412,1443,2855,374,360,734
2513984,1660,1704,3364,389,386,775
2514008,2120,2224,4344,549,514,1063
2514107,2247,2149,4396,512,496,1008
2514206,3680,3884,7564,919,963,1882
2514305,3052,2958,6010,935,849,1784
2514404,2501,2259,4760,685,583,1268
2514453,2759,2749,5508,751,741,1492
2514503,9529,9567,19096,2550.129,2498.298,5048.427
2514552,2139,2080,4219,604,573,1177
2514602,1626,1607,3233,435,422,857
2514651,849,835,1684,233,218,451
2514701,2042,1968,4010,555,495,1050
2514800,1982,2003,3985,464,457,921
2514909,3837,3911,7748,850,926,1776
2515005,3341,3355,6696,960,906,1866
2515104,5423,5618,11041,1399,1458,2857
2515203,1616,1619,3235,432,393,825
2515302,24653,25490,50143,6726,6805,13531
2515401,5261,4969,10230,1589,1475,3064
2515500,6334,6639,12973,1544,1593,3137
2515609,1595,1609,3204,451,391,842
2515708,1502,1473,2975,467,415,882
2515807,3359,3691,7050,895,884,1779
2515906,3092,3146,6238,785,753,1538
2515930,2143,2252,4395,518,557,1075
2515971,3679,3694,7373,1031,1045,2076
2516003,12764,13929,26693,3279,3488,6767
2516102,6770,6969,13739,1833,1755,3588
2516151,1581,1588,3169,410,415,825
2516201,31798,34005,65803,8584,8738,17322
2516300,7927,8133,16060,2078,2046,4124
2516409,5162,5100,10262,1495,1366,2861
2516508,7346,7590,14936,2038,1968,4006
2516607,7034,7069,14103,2004,1943,3947
2516706,6934,7219,14153,2017,1978,3995
2516755,1466,1347,2813,466,392,858
2516805,4570,4650,9220,1272,1264,2536
2516904,7011,7573,14584,1882,1949,3831
2517001,4509,4789,9298,1311,1274,2585
2517100,1268,1236,2504,325,303,628
2517209,2538,2507,5045,655,578,1233
2517407,1051,1024,2075,272,250,522
2600054,45125,49304,94429,12128,12764,24892
2600104,16790,18298,35088,4524,4782,9306
2600203,8750,8836,17586,2335,2419,4754
2600302,10935,11744,22679,2952,3157,6109
2600401,16610,16485,33095,4942,4972,9914
2600500,19666,20569,40235,5348,5290,10638
2600609,6913,6846,13759,1863,1663,3526
2600708,18579,18836,37415,5313,5255,10568
2600807,11106,11247,22353,2899,2798,5697
2600906,10984,10955,21939,3166,3149,6315
2601003,5018,5184,10202,1294,1315,2609
2601052,9027,9129,18156,2694,2676,5370
2601102,37836,39466,77302,10536,10774,21310
2601201,32369,36424,68793,9045,9471,18516
2601300,6515,6261,12776,1901,1809,3710
2601409,19885,20847,40732,5772,5874,11646
2601508,5635,5718,11353,1441.104,1502.335,2943.438
2601607,9960,10293,20253,2812,2792,5604
2601706,34780,37652,72432,9824,10119,19943
2601805,6008,5995,12003,1602,1592,3194
2601904,28050,30618,58668,7528,7661,15189
2602001,17621,17537,35158,5071,4800,9871
2602100,22004,23499,45503,5884,6087,11971
2602209,18477,19349,37826,5060,5118,10178
2602308,18577,18989,37566,5087,4874,9961
2602407,4334,4510,8844,1233,1176,2409
2602506,3608,3699,7307,1026,995,2021
2602605,22180,23000,45180,6600,6665,13265
2602704,6197,6340,12537,1713,1767,3480
2602803,25641,26464,52105,6861,6996,13857
2602902,90859,94166,185025,26543,26455,52998
2603009,15052,15821,30873,4338,4410,8748
2603108,9104,9715,18819,2532,2578,5110
2603207,13172,13405,26577,3869,3784,7653
2603306,5566,5559,11125,1547,1431,2978
2603405,2722,2926,5648,728,776,1504
2603454,69212,75254,144466,18796,19822,38618
2603504,8322,8782,17104,2298,2271,4569
2603603,4086,4070,8156,1102,1037,2139
2603702,12365,12156,24521,3469,3226,6695
2603801,9772,9821,19593,2770,2668,5438
2603900,9166,9408,18574,2442,2473,4915
2603926,5989,5793,11782,1788,1617,3405
2604007,35563,39295,74858,9734,10313,20047
2604106,149153,165759,314912,43420,46425,89845
2604155,6799,6967,13766,2005,1985,3990
2604205,18303,19517,37820,5174,5273,10447
2604304,5391,5387,10778,1643,1593,3236
2604403,6096,6308,12404,1812,1835,3647
2604502,9982,10155,20137,2788,2747,5535
2604601,11844,12438,24282,3133,3263,6396
2604700,8610,8809,17419,2509,2471,4980
2604809,6183,6269,12452,1858,1824,3682
2604908,8508,8675,17183,2373,2300,4673
2605004,11050,12340,23390,3076,3354,6430
2605103,16652,17203,33855,4548,4583,9131
2605152,8657,8260,16917,2369,2293,4662
2605202,31151,32366,63517,9046,9193,18239
2605301,15485,16151,31636,4333,4371,8704
2605400,9972,10599,20571,2710,2773,5483
2605459,1292,1338,2630,385,360,745
2605509,5642,5788,11430,1549,1569,3118
2605608,10938,11231,22169,2884,2822,5706
2605707,14431,14854,29285,4290,4246,8536
2605806,6998,7295,14293,1836,1801,3637
2605905,14102,13810,27912,4158,4115,8273
2606002,60976,68432,129408,17302,18523,35825
2606101,14166,14853,29019,4061,4222,8283
2606200,36644,39000,75644,10316,10449,20765
2606309,3451,3404,6855,931,906,1837
2606408,36904,39554,76458,10247,10489,20736
2606507,9180,9180,18360,2536,2421,4957
2606606,13350,13604,26954,3976,3946,7922
2606705,3791,3743,7534,977,943,1920
2606804,49316,52705,102021,13499,14202,27701
2606903,5915,5864,11779,1553,1437,2990
2607000,9555,9526,19081,2899,2896,5795
2607109,2290,2206,4496,593,570,1163
2607208,39890,40747,80637,12297,12414,24711
2607307,13855,14265,28120,3908,3848,7756
2607406,2135,2234,4369,610,626,1236
2607505,13042,13214,26256,3563,3506,7069
2607604,12564,9320,21884,4158,2398,6556
2607653,17484,17914,35398,5077,5008,10085
2607703,6850,7031,13881,1836,1797,3633
2607752,12007,11762,23769,3792,3201,6993
2607802,7882,7810,15692,2283,2192,4475
2607901,304850,339770,644620,83945,89366,173311
2607950,5705,5796,11501,1721,1695,3416
2608008,7860,7959,15819,2184,2110,4294
2608057,6837,7126,13963,1887,1932,3819
2608107,14870,15873,30743,4192,4155,8347
2608206,7900,7873,15773,2262,2296,4558
2608255,5272,5332,10604,1464,1427,2891
2608305,6683,7022,13705,1925,1918,3843
2608404,7133,7408,14541,1826,1803,3629
2608453,7854,8153,16007,2189,2206,4395
2608503,10070,10589,20659,2936,2973,5909
2608602,5970,6162,12132,1489,1605,3094
2608701,7825,7790,15615,2071,2047,4118
2608750,11317,11443,22760,3284,3239,6523
2608800,17418,19210,36628,4733,5230,9963
2608909,26826,28613,55439,7670,7156,14826
2609006,11666,12259,23925,3380,3362,6742
2609105,6551,7045,13596,1863,2021,3884
2609154,9128,8955,18083,2714,2513,5227
2609204,6170,6060,12230,1706,1733,3439
2609303,7116,7192,14308,2005,1982,3987
2609402,27664,29032,56696,7768,7914,15682
2609501,14747,16049,30796,3970,4070,8040
2609600,174724,203055,377779,46459.12,50341.47,96800.59
2609709,11067,11811,22878,3142,3161,6303
2609808,6571,6609,13180,1948,1910,3858
2609907,31699,32659,64358,8633,8778,17411
2610004,28803,30723,59526,8232,8464,16696
2610103,3986,4203,8189,1072,1047,2119
2610202,12588,13057,25645,3328,3449,6777
2610301,5518,5483,11001,1423,1330,2753
2610400,10280,9944,20224,2910,2670,5580
2610509,13980,14648,28628,3923,3908,7831
2610608,25205,26152,51357,7133,7414,14547
2610707,141630,158836,300466,37817,40151,77968
2610806,10473,10471,20944,2914,2645,5559
2610905,30615,32316,62931,8344,7997,16341
2611002,15947,16545,32492,4590,4749,9339
2611101,143252,150710,293962,42764.6,44923.29,87687.89
2611200,5375,5867,11242,1389,1424,2813
2611309,11882,12164,24046,3396,3344,6740
2611408,6882,6557,13439,2030,1916,3946
2611507,11918,12268,24186,3168.567,3352.753,6521.319
2611533,3325,3414,6739,986,972,1958
2611606,709819,827885,1537704,197117,209503,406620
2611705,9417,9745,19162,2555,2562,5117
2611804,21734,22705,44439,6210,6303,12513
2611903,11127,11024,22151,3315,3247,6562
2612000,5534,5706,11240,1383,1370,2753
2612109,4679,4633,9312,1372,1323,2695
2612208,27604,29025,56629,7887,7909,15796
2612307,7383,7926,15309,1899,1992,3891
2612406,10760,11195,21955,2827,2908,5735
2612455,6810,6784,13594,1764,1759,3523
2612471,5812,5956,11768,1618,1622,3240
2612505,42373,45209,87582,13992,14993,28985
2612554,6759,6612,13371,1765,1765,3530
2612604,19868,19567,39435,5860,5519,11379
2612703,6474,6547,13021,1724,1699,3423
2612802,5385,5606,10991,1565,1589,3154
2612901,7017,6924,13941,2086,2039,4125
2613008,26564,26678,53242,7377,7179,14556
2613107,17203,18071,35274,4979,4847,9826
2613206,10441,10871,21312,2935,2975,5910
2613305,10195,10293,20488,2828,2731,5559
2613404,8867,9313,18180,2523,2547,5070
2613503,16241,16376,32617,4637,4395,9032
2613602,15518,16311,31829,4185,4208,8393
2613701,50016,52879,102895,14311,14617,28928
2613800,8369,8631,17000,2407,2429,4836
2613909,37827,41405,79232,10723,11336,22059
2614006,9199,9132,18331,2640,2468,5108
2614105,16500,17287,33787,4464,4524,8988
2614204,20348,19948,40296,6302,6085,12387
2614303,5591,5541,11132,1620,1476,3096
2614402,2902,2842,5744,824,804,1628
2614501,27994,30521,58515,7744,8079,15823
2614600,12967,13460,26427,3558,3494,7052
2614709,6256,6469,12725,1779,1714,3493
2614808,11159,10909,22068,3206,2927,6133
2614857,10410,10305,20715,3141,3085,6226
2615003,12332,12571,24903,3547,3558,7105
2615102,3271,3466,6737,899,918,1817
2615201,4723,4555,9278,1277,1227,2504
2615300,25904,27921,53825,7197,7392,14589
2615409,17421,18133,35554,6060,6092,12152
2615508,6363,6692,13055,1813,1898,3711
2615607,12896,13220,26116,3799,3654,7453
2615706,7180,7826,15006,2007,2011,4018
2615805,12115,12310,24425,3294,3293,6587
2615904,3852,4073,7925,983,993,1976
2616001,7860,8192,16052,2161,2186,4347
2616100,4484,4658,9142,1243,1177,2420
2616183,3867,4006,7873,1101,1044,2145
2616209,8936,9286,18222,2493,2551,5044
2616308,15183,15549,30732,4734,4662,9396
2616407,62409,67565,129974,17800,18285,36085
2616506,6995,7098,14093,2009,1960,3969
2700102,9655,9722,19377,2666,2603,5269
2700201,8569,8855,17424,2449,2433,4882
2700300,101884,112122,214006,29384,31688,61072
2700409,22209,22113,44322,6330,6175,12505
2700508,7077,7153,14230,2074,2094,4168
2700607,3763,3811,7574,1144,1104,2248
2700706,8386,8690,17076,2486,2481,4967
2700805,2222,2329,4551,626,636,1262
2700904,3550,3480,7030,1058,975,2033
2701001,12769,13007,25776,3638,3650,7288
2701100,5379,5204,10583,1617,1505,3122
2701209,5048,5147,10195,1359,1349,2708
2701308,10078,10331,20409,2928,3003,5931
2701357,3288,3310,6598,888,874,1762
2701407,25025,25791,50816,7747,8126,15873
2701506,4437,4595,9032,1257,1317,2574
2701605,8662,8588,17250,2269,2250,4519
2701704,8430,8647,17077,2349,2352,4701
2701803,4058,4232,8290,1130,1161,2291
2701902,3644,3502,7146,1009,899,1908
2702009,5422,5504,10926,1468,1541,3009
2702108,10073,9946,20019,2810,2731,5541
2702207,2756,2770,5526,791,755,1546
2702306,25748,26382,52130,7627,7889,15516
2702355,11157,11484,22641,3190,3212,6402
2702405,23052,25044,48096,6430,6917,13347
2702504,5454,5426,10880,1475,1505,2980
2702553,8404,8847,17251,2215,2326,4541
2702603,10561,10760,21321,3017,3068,6085
2702702,2131,2214,4345,627,633,1260
2702801,6232,6093,12325,1692,1648,3340
2702900,18165,18435,36600,5285,5378,10663
2703007,7573,7576,15149,2079,2015,4094
2703106,12270,12918,25188,3305,3585,6890
2703205,11747,11545,23292,3550,3428,6978
2703304,8811,9087,17898,2278,2479,4757
2703403,2671,2742,5413,750,749,1499
2703502,3587,3410,6997,1033,967,2000
2703601,3874,3880,7754,1101,1082,2183
2703700,2805,2753,5558,837,808,1645
2703759,6128,5901,12029,1777,1725,3502
2703809,11520,11055,22575,3167,3006,6173
2703908,2126,2076,4202,596,566,1162
2704005,11743,12093,23836,3482,3454,6936
2704104,8971,9279,18250,2574,2516,5090
2704203,13424,13568,26992,3901,3993,7894
2704302,436492,496256,932748,122711.1,135728.4,258439.5
2704401,9268,9629,18897,2506,2633,5139
2704500,14516,14233,28749,4178,4263,8441
2704609,5197,5087,10284,1461,1349,2810
2704708,22709,23268,45977,6355,6541,12896
2704807,6537,7082,13619,1888,1871,3759
2704906,1821,1831,3652,434,456,890
2705002,12332,12366,24698,3356,3358,6714
2705101,11597,12188,23785,3219,3423,6642
2705200,7703,7979,15682,2212,2262,4474
2705309,2616,2659,5275,744,715,1459
2705408,3358,3577,6935,941,973,1914
2705507,13278,13432,26710,3929,3851,7780
2705606,6120,5940,12060,1893,1682,3575
2705705,9722,10642,20364,2691,2934,5625
2705804,4278,4213,8491,1268,1225,2493
2705903,2463,2494,4957,658,660,1318
2706000,5561,5486,11047,1585,1480,3065
2706109,5437,5475,10912,1543,1459,3002
2706208,2474,2638,5112,639,698,1337
2706307,33582,36786,70368,9031,9715,18746
2706406,11758,12053,23811,3311,3412,6723
2706422,5114,5150,10264,1379,1343,2722
2706448,5590,5757,11347,1591,1613,3204
2706505,7512,7251,14763,2152,2013,4165
2706604,3631,3795,7426,1052,1038,2090
2706703,29308,31070,60378,8462,8659,17121
2706802,8615,8588,17203,2427,2395,4822
2706901,16167,17138,33305,4411,4868,9279
2707008,1420,1446,2866,395,386,781
2707107,11294,11751,23045,3143,3337,6480
2707206,7002,6870,13872,1957,1895,3852
2707305,12754,12954,25708,3529,3629,7158
2707404,4270,4159,8429,1211,1157,2368
2707503,9594,9740,19334,2810,2754,5564
2707602,5671,5809,11480,1645,1601,3246
2707701,33301,35180,68481,9249,9486,18735
2707800,3369,3287,6656,918,939,1857
2707909,3370,3521,6891,944,939,1883
2708006,21811,23121,44932,6154,6411,12565
2708105,5490,5471,10961,1582,1579,3161
2708204,3334,3384,6718,880,896,1776
2708303,11172,11514,22686,3112,3085,6197
2708402,14850,15238,30088,4128,4125,8253
2708501,16328,16084,32412,4785,4627,9412
2708600,26565,28012,54577,7902,8231,16133
2708709,3563,3600,7163,977,999,1976
2708808,15851,16159,32010,4454,4634,9088
2708907,7106,7497,14603,2052,2169,4221
2708956,6405,6642,13047,1752,1855,3607
2709004,3020,3102,6122,876,837,1713
2709103,9237,9783,19020,2464,2669,5133
2709152,20164,20988,41152,5684,6018,11702
2709202,12951,12751,25702,3575,3349,6924
2709301,30171,32187,62358,8513,8969,17482
2709400,12410,12997,25407,3515,3526,7041
2800100,1135,1140,2275,326,313,639
2800209,9805,10251,20056,2635,2740,5375
2800308,265484,305665,571149,79049,87210,166259
2800407,5487,5391,10878,1589,1495,3084
2800506,8493,8364,16857,2589,2297,4886
2800605,12212,12764,24976,3496,3640,7136
2800670,12538,12995,25533,3422,3459,6881
2800704,3936,3806,7742,1171,1042,2213
2801009,8233,8516,16749,2236,2267,4503
2801108,2061,1895,3956,576,504,1080
2801207,12293,12393,24686,3588,3633,7221
2801306,15269,15492,30761,4426,4382,8808
2801405,9970,10037,20007,2699,2665,5364
2801504,6671,6832,13503,2004,2064,4068
2801603,2780,2853,5633,665,731,1396
2801702,8295,8224,16519,2390,2378,4768
2801900,1903,1910,3813,519,503,1022
2802007,2189,2137,4326,612,570,1182
2802106,31365,33044,64409,9167,9420,18587
2802205,2630,2694,5324,733,707,1440
2802304,6785,7089,13874,1993,1958,3951
2802403,5811,5594,11405,1550.616,1431.482,2982.098
2802502,1423,1506,2929,425,417,842
2802601,2889,2756,5645,766,738,1504
2802700,4168,4180,8348,1186,1132,2318
2802809,8027,7804,15831,2333,2206,4539
2802908,42496,44471,86967,12414,12816,25230
2803005,19379,19531,38910,5521,5488,11009
2803104,2478,2494,4972,618,593,1211
2803203,15165,15254,30419,4477,4504,8981
2803302,8389,8475,16864,2444,2393,4837
2803401,6482,6456,12938,1882,1831,3713
2803500,46489,48372,94861,13010,13288,26298
2803609,13131,13771,26902,4136,4250,8386
2803708,3162,3239,6401,878,831,1709
2803807,1753,1703,3456,466,465,931
2803906,6081,5961,12042,1730,1598,3328
2804003,8011,8332,16343,2390,2412,4802
2804102,5462,5539,11001,1491,1475,2966
2804201,6900,6727,13627,1992,1906,3898
2804300,3685,3659,7344,1115,1053,2168
2804409,9233,9273,18506,2649,2592,5241
2804458,4257,4251,8508,1180,1127,2307
2804508,16076,16421,32497,4741,4756,9497
2804607,12127,12453,24580,3444,3443,6887
2804706,3151,3087,6238,836,832,1668
2804805,78287,82540,160827,23270,23798,47068
2804904,6687,6450,13137,1940,1898,3838
2805000,1496,1478,2974,424,413,837
2805109,4356,4477,8833,1256,1216,2472
2805208,2926,3047,5973,790,798,1588
2805307,4213,4156,8369,1226,1234,2460
2805406,15767,15113,30880,4595,4413,9008
2805505,10866,11117,21983,2907,2900,5807
2805604,13883,13263,27146,4004,3769,7773
2805703,13846,14605,28451,3975,4109,8084
2805802,9736,9650,19386,2745,2593,5338
2805901,4554,4801,9355,1376,1436,2812
2806008,8492,8681,17173,2349,2365,4714
2806107,4439,4782,9221,1306,1408,2714
2806206,9658,9707,19365,2689,2642,5331
2806305,6654,6315,12969,1937,1825,3762
2806404,3537,3501,7038,1090,1040,2130
2806503,1887,1862,3749,494,489,983
2806602,5612,5798,11410,1639,1561,3200
2806701,38399,40465,78864,11430,11578,23008
2806800,5091,5180,10271,1389,1397,2786
2806909,1708,1685,3393,440,435,875
2807006,1840,1858,3698,536,525,1061
2807105,18888,19814,38702,5219,5393,10612
2807204,3989,4015,8004,1099,1110,2209
2807303,1476,1481,2957,412,412,824
2807402,23459,24581,48040,6737,6747,13484
2807501,6536,6319,12855,1928,1798,3726
2807600,11000,11434,22434,3297,3289,6586
2900108,4082,4234,8316,988,999,1987
2900207,8564,8500,17064,2519,2350,4869
2900306,7208,7445,14653,1932,1902,3834
2900355,7907,7795,15702,2209,2218,4427
2900405,7903,7828,15731,2367,2191,4558
2900504,5422,5437,10859,1623,1532,3155
2900603,2351,2251,4602,657,609,1266
2900702,67212,74737,141949,19429,20725,40154
2900801,10815,10456,21271,2966,2916,5882
2900900,3200,3157,6357,844,797,1641
2901007,16647,17704,34351,4565,4666,9231
2901106,12283,12907,25190,3514,3460,6974
2901155,8073,7888,15961,2128,2095,4223
2901205,12892,12624,25516,3293,3158,6451
2901304,7181,6779,13960,2102,1882,3984
2901353,7328,7086,14414,2048,1936,3984
2901403,7460,6613,14073,2175,1806,3981
2901502,5083,5159,10242,1488,1431,2919
2901601,8581,8491,17072,2381,2365,4746
2901700,5734,5820,11554,1833,1683,3516
2901809,5573,5442,11015,1485,1434,2919
2901908,8961,8770,17731,2342,2201,4543
2901957,3794,3665,7459,1090,1051,2141
2902005,7052,6691,13743,1977,1822,3799
2902054,5828,5733,11561,1868,1784,3652
2902104,25940,25711,51651,7350,6904,14254
2902203,4999,5037,10036,1462,1444,2906
2902252,5502,4890,10392,1343,1283,2626
2902302,4376,4223,8599,1328,1216,2544
2902401,6833,6762,13595,2010,1951,3961
2902500,7162,6688,13850,1982,1810,3792
2902609,9966,10094,20060,2622,2600,5222
2902658,5993,5821,11814,1679,1552,3231
2902708,25160,24165,49325,7338,6904,14242
2902807,10648,10539,21187,3219,3234,6453
2902906,17553,17235,34788,5161,4924,10085
2903003,7012,6975,13987,1761,1652,3413
2903102,3337,2976,6313,962,861,1823
2903201,67913,69514,137427,21222,22280,43502
2903235,6909,6703,13612,1858,1712,3570
2903276,7218,6973,14191,2298,2169,4467
2903300,3306,3147,6453,929,875,1804
2903409,11159,10639,21798,2947,2908,5855
2903508,8120,7901,16021,2244,2021,4265
2903607,7553,7283,14836,2173,2082,4255
2903706,7824,7587,15411,2161,2039,4200
2903805,9134,8857,17991,2549,2404,4953
2903904,31676,31804,63480,9316,9233,18549
2903953,5191,4922,10113,1544,1428,2972
2904001,6702,6993,13695,1914,1872,3786
2904050,7521,7313,14834,2231,2133,4364
2904100,10856,11181,22037,3099,2946,6045
2904209,5608,5546,11154,1548,1503,3051
2904308,7114,7168,14282,2139,2078,4217
2904407,5798,5279,11077,1521,1400,2921
2904506,5472,5245,10717,1275,1183,2458
2904605,31747,32855,64602,8719,8934,17653
2904704,9307,9298,18605,2466,2487,4953
2904753,10202,9398,19600,3227,2822,6049
2904803,5992,5428,11420,1717,1546,3263
2904852,8549,8778,17327,2650,2541,5191
2904902,15453,16573,32026,4626,4875,9501
2905008,11137,11099,22236,3108,2986,6094
2905107,5140,5228,10368,1386,1365,2751
2905156,7054,6585,13639,2036,1971,4007
2905206,23419,24096,47515,6984,6999,13983
2905305,8764,8445,17209,2531,2281,4812
2905404,7841,7533,15374,2480,2345,4825
2905503,6152,6339,12491,1736,1764,3500
2905602,15734,15738,31472,4192,4273,8465
2905701,120704,122266,242970,37067,37933,75000
2905800,17899,17281,35180,5072,4935,10007
2905909,14142,13948,28090,3884,3851,7735
2906006,33464,33152,66616,9262,9117,18379
2906105,4808,4602,9410,1247,1227,2474
2906204,12126,11941,24067,3276,3139,6415
2906303,16089,16247,32336,4246,4300,8546
2906402,4499,4396,8895,1216,1091,2307
2906501,40314,42844,83158,11882,12394,24276
2906600,6815,6395,13210,1914,1731,3645
2906709,14032,13886,27918,3748,3696,7444
2906808,16560,16348,32908,4425,4278,8703
2906824,7997,7735,15732,2127,2031,4158
2906857,5808,5719,11527,1563,1403,2966
2906873,12998,13579,26577,3640,3757,7397
2906899,5216,5006,10222,1312,1337,2649
2906907,10873,10541,21414,2888.448,2729.22,5617.668
2907004,4502,4397,8899,1362,1313,2675
2907103,14523,13857,28380,4262,3865,8127
2907202,33091,31849,64940,9331,8717,18048
2907301,12268,13140,25408,3651,3619,7270
2907400,1354,1258,2612,340,328,668
2907509,24816,26261,51077,7194,7441,14635
2907558,4543,4300,8843,1338,1176,2514
2907608,8689,8324,17013,2238,2028,4266
2907707,5442,5292,10734,1505,1394,2899
2907806,15860,16440,32300,4233,4205,8438
2907905,7678,8077,15755,2241,2271,4512
2908002,10274,10690,20964,2599,2703,5302
2908101,9303,8850,18153,2636,2359,4995
2908200,9922,10469,20391,2917,2855,5772
2908309,8704,9185,17889,2444,2407,4851
2908408,30707,31333,62040,8646,8715,17361
2908507,14559,15564,30123,4177,4276,8453
2908606,11834,11786,23620,3433,3201,6634
2908705,8270,8628,16898,2036,2057,4093
2908804,2380,2283,4663,629,587,1216
2908903,10841,11560,22401,3165,3125,6290
2909000,4048,4120,8168,1096,1098,2194
2909109,7199,7108,14307,1895,1818,3713
2909208,8796,8270,17066,2419,2294,4713
2909307,15763,15486,31249,4447,4304,8751
2909406,7115,6521,13636,2081,1837,3918
2909505,2557,2484,5041,747,681,1428
2909604,10236,9810,20046,2680,2562,5242
2909703,6869,6411,13280,2025,1775,3800
2909802,27682,30924,58606,8094,8659,16753
2909901,16467,15701,32168,4640,4330,8970
2910008,6726,6110,12836,1875,1752,3627
2910057,32818,33622,66440,9680,9956,19636
2910107,5870,5485,11355,1673,1536,3209
2910206,1897,1977,3874,500,525,1025
2910305,3957,3990,7947,1006,1008,2014
2910404,12376,11390,23766,3402,3147,6549
2910503,19631,20241,39872,5704.452,5901.958,11606.41
2910602,16334,16468,32802,4736,4601,9337
2910701,28319,27970,56289,7570,7444,15014
2910727,49396,50800,100196,13918,14625,28543
2910750,8949,8703,17652,2514,2350,4864
2910776,3197,2987,6184,846,804,1650
2910800,263999,292643,556642,78556,84017,162573
2910859,8437,8303,16740,2387,2230,4617
2910909,2732,2652,5384,779,765,1544
2911006,5438,5222,10660,1435,1341,2776
2911105,11660,10868,22528,3704,3387,7091
2911204,15103,15233,30336,4397,4470,8867
2911253,2356,2205,4561,651,565,1216
2911303,5448,5174,10622,1397,1322,2719
2911402,7539,7537,15076,2237,2148,4385
2911501,4235,4122,8357,1281,1211,2492
2911600,9497,10321,19818,2874,2896,5770
2911659,5242,5170,10412,1504,1414,2918
2911709,38481,40352,78833,10932,11499,22431
2911808,11618,10547,22165,3008,2698,5706
2911857,6666,6526,13192,1826,1757,3583
2911907,12631,13105,25736,3542,3405,6947
2912004,5097,4965,10062,1325,1318,2643
2912103,11888,12384,24272,2962,3101,6063
2912202,8754,8528,17282,2943,2873,5816
2912301,8063,7722,15785,2133,2059,4192
2912400,8758,8250,17008,2344,2174,4518
2912509,7048,7123,14171,2001,1989,3990
2912608,2529,2337,4866,660,577,1237
2912707,11534,11064,22598,3072,3058,6130
2912806,4098,3858,7956,1009,1039,2048
2912905,9440,9503,18943,2597,2611,5208
2913002,7695,7813,15508,2145,2055,4200
2913101,9058,8782,17840,2413,2246,4659
2913200,12802,12622,25424,3669,3664,7333
2913309,2588,2667,5255,715,698,1413
2913408,7643,7562,15205,2207,2212,4419
2913457,7042,6301,13343,2067,1833,3900
2913507,13123,12582,25705,3400,3298,6698
2913606,89440,94796,184236,24187,25427,49614
2913705,18028,18278,36306,5327,5057,10384
2913804,7586,7745,15331,2294,2203,4497
2913903,21831,22559,44390,6142,6255,12397
2914000,29076,30267,59343,8167,8254,16421
2914109,4741,4544,9285,1241,1120,2361
2914208,3506,3496,7002,928,886,1814
2914307,6167,5823,11990,1757.832,1527.881,3285.713
2914406,11244,11357,22601,3176,3181,6357
2914505,13297,14169,27466,3951,4006,7957
2914604,32018,34163,66181,9138,9748,18886
2914653,14481,13909,28390,4258,3964,8222
2914703,29935,31696,61631,8545,8898,17443
2914802,96936,107731,204667,27112.32,29835.16,56947.48
2914901,12697,11621,24318,3677,3449,7126
2915007,7513,7411,14924,2213,2020,4233
2915106,6588,6463,13051,1737,1692,3429
2915205,7804,7389,15193,2184,2134,4318
2915304,3556,3554,7110,897,939,1836
2915353,6959,6250,13209,1965,1727,3692
2915403,3699,3610,7309,887,931,1818
2915502,10452,10629,21081,2754,2896,5650
2915601,31460,31609,63069,8770,8626,17396
2915700,4036,3867,7903,1057,1026,2083
2915809,11583,11506,23089,3214,3186,6400
2915908,3885,3713,7598,1182,1131,2313
2916005,10295,9921,20216,2646,2440,5086
2916104,10166,10559,20725,2727.573,2731.894,5459.467
2916203,5608,5387,10995,1594,1492,3086
2916302,5260,5235,10495,1273,1388,2661
2916401,33449,34824,68273,9906,10001,19907
2916500,16467,15794,32261,4550,4220,8770
2916609,5178,5029,10207,1430,1425,2855
2916708,3842,3836,7678,1080,1071,2151
2916807,9523,9016,18539,2609,2435,5044
2916856,7252,7270,14522,2214,2126,4340
2916906,6241,6452,12693,1769,1695,3464
2917003,18317,17796,36113,5041,4678,9719
2917102,9990,9924,19914,2779,2695,5474
2917201,9031,9096,18127,2591,2466,5057
2917300,13388,13203,26591,3962,3810,7772
2917334,5646,5254,10900,1782,1564,3346
2917359,4660,4313,8973,1339,1219,2558
2917409,6926,6725,13651,1933,1787,3720
2917508,38328,40919,79247,10384,11224,21608
2917607,25042,25969,51011,6746,6994,13740
2917706,15438,14905,30343,4077,3915,7992
2917805,8449,8018,16467,2443,2264,4707
2917904,5309,5022,10331,1471,1371,2842
2918001,73612,78283,151895,20760,21661,42421
2918100,19018,18662,37680,5213,4849,10062
2918209,7155,6963,14118,2097,1968,4065
2918308,7124,6991,14115,2016,1918,3934
2918357,11383,11166,22549,3158,3081,6239
2918407,97085,100880,197965,28120,28863,56983
2918456,5399,4891,10290,1387,1318,2705
2918506,7812,7240,15052,2189,1921,4110
2918555,3280,3194,6474,861,802,1663
2918605,3907,4124,8031,1037,949,1986
2918704,2030,1871,3901,538,524,1062
2918753,7200,6734,13934,2293,2046,4339
2918803,11286,10915,22201,3246,3069,6315
2918902,1837,1896,3733,472,457,929
2919009,2045,1891,3936,541,512,1053
2919058,4187,4118,8305,1120,1119,2239
2919108,4761,4799,9560,1355,1321,2676
2919157,13083,12563,25646,3669,3445,7114
2919207,79276,84173,163449,22516.03,23788.67,46304.71
2919306,5210,5158,10368,1560,1525,3085
2919405,6276,6035,12311,1728,1578,3306
2919504,21492,21201,42693,6116,6006,12122
2919553,31056,29049,60105,10489.23,10175.65,20664.88
2919603,5520,5709,11229,1437,1333,2770
2919702,8583,8510,17093,2513,2400,4913
2919801,23541,23510,47051,6745,6830,13575
2919900,4001,4072,8073,1085,1113,2198
2919926,8377,8999,17376,2481,2488,4969
2919959,3581,3457,7038,938,896,1834
2920007,4544,4238,8782,1238,1148,2386
2920106,9555,9771,19326,2660,2432,5092
2920205,8285,7729,16014,2468,2177,4645
2920304,4322,4146,8468,1183,1090,2273
2920403,7338,7049,14387,2025,1893,3918
2920452,6585,6007,12592,2010,1816,3826
2920502,12204,12409,24613,3419,3438,6857
2920601,21516,21299,42815,6509,5963,12472
2920700,10076,9025,19101,2868,2639,5507
2920809,5298,5202,10500,1532,1425,2957
2920908,7551,7089,14640,1913,1811,3724
2921005,19879,20304,40183,6075,5905,11980
2921054,5674,5471,11145,1685,1572,3257
2921104,11049,10511,21560,2860,2595,5455
2921203,13197,13278,26475,3657,3643,7300
2921302,5003,5303,10306,1377,1411,2788
2921401,8176,8103,16279,2285,2203,4488
2921450,5393,5114,10507,1528,1398,2926
2921500,26586,25752,52338,7047,6708,13755
2921609,4241,4039,8280,1081,1040,2121
2921708,17688,17476,35164,4793,4610,9403
2921807,6227,6250,12477,1696,1594,3290
2921906,5228,5317,10545,1544,1512,3056
2922003,18186,17840,36026,5133,5105,10238
2922052,6175,6074,12249,1831,1726,3557
2922102,12365,12030,24395,3634,3225,6859
2922201,3681,3636,7317,1047,1009,2056
2922250,5449,4823,10272,1529,1388,2917
2922300,13726,15173,28899,4059,4195,8254
2922409,10597,10852,21449,2975,3009,5984
2922508,13225,14049,27274,3876,3875,7751
2922607,6464,6066,12530,1956,1725,3681
2922656,6407,5964,12371,1766,1662,3428
2922706,8571,8142,16713,2029,1868,3897
2922730,3793,3809,7602,934,952,1886
2922755,3492,3156,6648,963,909,1872
2922805,3771,3664,7435,1048,1037,2085
2922854,4069,3965,8034,1196,1161,2357
2922904,12130,12006,24136,3082,2912,5994
2923001,19418,19138,38556,5275,5362,10637
2923035,5502,5171,10673,1555,1434,2989
2923050,7533,7518,15051,2126,2235,4361
2923100,12290,12653,24943,3392,3323,6715
2923209,11131,10700,21831,2949,2782,5731
2923308,4217,4081,8298,1342,1200,2542
2923357,8362,8063,16425,2306,2264,4570
2923407,10599,10176,20775,3207,2904,6111
2923506,4174,4236,8410,1075,1088,2163
2923605,10565,10436,21001,3067,2948,6015
2923704,14930,14574,29504,4521,4253,8774
2923803,13670,14108,27778,3732,3689,7421
2923902,5495,5357,10852,1417,1401,2818
2924009,51970,56426,108396,14111,15025,29136
2924058,6817,6935,13752,1779,1801,3580
2924108,3394,3482,6876,971,934,1905
2924207,8683,8312,16995,2481,2465,4946
2924306,8734,9248,17982,2179,2310,4489
2924405,16683,16177,32860,4772,4538,9310
2924504,8017,7611,15628,2316,2207,4523
2924603,10329,9792,20121,2688,2627,5315
2924652,5198,5144,10342,1494,1357,2851
2924678,5194,4605,9799,1561,1402,2963
2924702,6440,6343,12783,1865.653,1722.409,3588.062
2924801,11287,11112,22399,2885,2796,5681
2924900,4574,4248,8822,1339,1224,2563
2925006,12092,12389,24481,3293,3337,6630
2925105,21762,22939,44701,5665,5974,11639
2925204,16078,16988,33066,4880,4990,9870
2925253,7924,7818,15742,2260,2173,4433
2925303,63489,63440,126929,17802,18724,36526
2925402,5066,4744,9810,1444,1318,2762
2925501,13990,13637,27627,3714,3663,7377
2925600,6992,6758,13750,1868,1703,3571
2925709,6978,6674,13652,1930,1720,3650
2925758,12212,11634,23846,3727,3561,7288
2925808,12285,12317,24602,3185,3209,6394
2925907,14011,13217,27228,3781,3459,7240
2925931,4879,4675,9554,1316,1197,2513
2925956,11136,11738,22874,3059,3096,6155
2926004,19451,19506,38957,5163,5095,10258
2926103,6025,6030,12055,1688,1651,3339
2926202,11440,10497,21937,3350,2970,6320
2926301,16169,17003,33172,4350,4462,8812
2926400,15594,15052,30646,4507,4154,8661
2926509,7234,7042,14276,2063,1871,3934
2926608,23376,24142,47518,6340,6471,12811
2926657,4474,4128,8602,1222,1118,2340
2926707,6233,6774,13007,1667,1711,3378
2926806,7441,7374,14815,2089,2038,4127
2926905,5928,5990,11918,1758,1649,3407
2927002,18654,18510,37164,5327,5117,10444
2927101,3835,3940,7775,1110,1097,2207
2927200,14549,15338,29887,3995,3906,7901
2927309,6554,6902,13456,1959,1927,3886
2927408,1248897,1426759,2675656,361029,392166.8,753195.9
2927507,9300,9764,19064,2468,2512,4980
2927606,7715,7345,15060,2201,2060,4261
2927705,13331,12933,26264,3589,3625,7214
2927804,3422,3251,6673,1019,912,1931
2927903,5135,5228,10363,1437,1359,2796
2928000,16620,17218,33838,4680,4816,9496
2928059,7051,6293,13344,1861,1677,3538
2928109,20337,19972,40309,5763,5487,11250
2928208,12551,12199,24750,3299,3069,6368
2928307,4246,4530,8776,1131,1113,2244
2928406,13572,12678,26250,3914,3552,7466
2928505,4822,4826,9648,1314,1174,2488
2928604,27755,30045,57800,7775,7937,15712
2928703,42965,48020,90985,12754,13795,26549
2928802,22906,24974,47880,7071,7506,14577
2928901,14530,13129,27659,4476,4034,8510
2928950,4591,4635,9226,1161,1199,2360
2929008,6882,7216,14098,2207,2065,4272
2929057,6536,6512,13048,1866,1870,3736
2929107,10083,10222,20305,2823,2780,5603
2929206,16203,16980,33183,4780,4998,9778
2929255,9449,8978,18427,2649,2454,5103
2929305,16019,17264,33283,4708,4830,9538
2929354,2902,2813,5715,770,754,1524
2929370,5094,5086,10180,1378,1294,2672
2929404,5278,5136,10414,1415,1304,2719
2929503,20708,21445,42153,5879,6130,12009
2929602,7978,8607,16585,2359,2332,4691
2929701,9567,9397,18964,2692,2541,5233
2929750,5482,5719,11201,1443,1384,2827
2929800,5933,5912,11845,1537,1565,3102
2929909,20685,21113,41798,5782,5721,11503
2930006,5254,5117,10371,1666,1568,3234
2930105,36020,38399,74419,9594,9917,19511
2930154,16377,15261,31638,4747,4300,9047
2930204,19277,18148,37425,5452,5158,10610
2930303,9243,8869,18112,2620,2444,5064
2930402,7587,7814,15401,2190,2010,4200
2930501,37680,39082,76762,11276,11264,22540
2930600,6040,6304,12344,1701,1634,3335
2930709,58013,60034,118047,17001,17635,34636
2930758,6265,5785,12050,1814,1731,3545
2930766,6282,6310,12592,1681,1695,3376
2930774,10799,11201,22000,2922,2864,5786
2930808,8053,7846,15899,2302,2094,4396
2930907,5939,5492,11431,1639,1544,3183
2931004,10071,9942,20013,2817,2703,5520
2931053,8126,8002,16128,2320,2162,4482
2931103,3977,4031,8008,1106,1038,2144
2931202,9586,9162,18748,2793,2676,5469
2931301,8337,8179,16516,2629,2509,5138
2931350,68077,70264,138341,19452,20142,39594
2931400,3856,4039,7895,1085,1074,2159
2931509,10801,10681,21482,3195,3068,6263
2931608,7725,7111,14836,2405,2274,4679
2931707,6221,6582,12803,1742,1739,3481
2931806,8532,8497,17029,2260,2182,4442
2931905,26254,26164,52418,7184,7014,14198
2932002,12218,12076,24294,3133,3070,6203
2932101,10035,9715,19750,2816,2656,5472
2932200,10100,10591,20691,2872,3049,5921
2932309,12488,12516,25004,3410,3521,6931
2932408,6968,6657,13625,1840,1669,3509
2932457,8777,8223,17000,2647,2528,5175
2932507,12557,11553,24110,3384,3308,6692
2932606,8331,8135,16466,2458,2332,4790
2932705,9857,9980,19837,2802,2817,5619
2932804,8936,9237,18173,2437,2488,4925
2932903,43531,45142,88673,12597,13082,25679
2933000,12152,12408,24560,3451,3520,6971
2933059,6984,6802,13786,1950,1770,3720
2933109,4355,4306,8661,1169,1102,2271
2933158,6622,6451,13073,1822,1693,3515
2933174,4534,4575,9109,1217,1190,2407
2933208,18722,18845,37567,4832,4705,9537
2933257,3564,3236,6800,861,761,1622
2933307,147879,158987,306866,41687,44822,86509
2933406,4498,4485,8983,1308,1251,2559
2933455,6496,5989,12485,1841,1658,3499
2933505,11475,10714,22189,3455,3215,6670
2933604,22509,23027,45536,6499,6454,12953
3100104,3400,3304,6704,746,757,1503
3100203,11230,11460,22690,2695,2641,5336
3100302,6669,6642,13311,1628,1608,3236
3100401,1894,2026,3920,454,485,939
3100500,5228,5048,10276,1230,1165,2395
3100609,7742,7453,15195,2001,1856,3857
3100708,1073,952,2025,279,232,511
3100807,2061,1993,4054,458,450,908
3100906,9318,9161,18479,2499,2309,4808
3101003,6526,6196,12722,1877,1618,3495
3101102,12061,12898,24959,2886,2918,5804
3101201,3206,2956,6162,693,685,1378
3101300,1408,1301,2709,307,272,579
3101409,1488,1425,2913,362,350,712
3101508,16538,17811,34349,3959,3957,7916
3101607,36081,37693,73774,9616,9603,19219
3101631,3110,2965,6075,772,760,1532
3101706,19534,19241,38775,5291,5026,10317
3101805,3590,3582,7172,882,851,1733
3101904,9493,8995,18488,2543,2244,4787
3102001,6981,6736,13717,1628,1612,3240
3102050,2726,2571,5297,738,658,1396
3102100,6102,6057,12159,1536,1435,2971
3102209,2239,2205,4444,576,498,1074
3102308,7535,7726,15261,1872,1802,3674
3102407,1779,1767,3546,416,456,872
3102506,2484,2569,5053,547,598,1145
3102605,18681,18589,37270,4737.604,4386.189,9123.793
3102704,4510,4449,8959,1099,1087,2186
3102803,6066,6107,12173,1337,1329,2666
3102852,3950,4053,8003,1069,1161,2230
3102902,5530,5584,11114,1378,1348,2726
3103009,4829,4736,9565,1227,1194,2421
3103108,861,810,1671,183,176,359
3103207,1083,1160,2243,258,279,537
3103306,1053,1005,2058,238,205,443
3103405,17848,18165,36013,5047,4947,9994
3103504,54160,55641,109801,13855,13441,27296
3103603,1415,1408,2823,268,294,562
3103702,4191,3961,8152,1211,1051,2262
3103751,3111,3033,6144,880,824,1704
3103801,1406,1369,2775,296,268,564
3103900,4010,3873,7883,1067,1044,2111
3104007,46265,47407,93672,12660,12457,25117
3104106,4914,4595,9509,1384,1160,2544
3104205,18209,18388,36597,4800,4692,9492
3104304,6925,6806,13731,1802,1679,3481
3104403,1485,1416,2901,343,324,667
3104452,2429,2341,4770,648,626,1274
3104502,9171,8503,17674,2313,2200,4513
3104601,6553,6496,13049,1709,1636,3345
3104700,7311,7144,14455,1826,1636,3462
3104809,2525,2435,4960,613,599,1212
3104908,9175,9132,18307,2223,2273,4496
3105004,3941,3972,7913,962,935,1897
3105103,11252,11482,22734,2649,2531,5180
3105202,2537,2450,4987,596,558,1154
3105301,2742,2596,5338,694,684,1378
3105400,14070,14372,28442,3947,3901,7848
3105509,2847,2873,5720,659,671,1330
3105608,60162,66122,126284,15718,15945,31663
3105707,3022,3121,6143,648,634,1282
3105905,9550,10049,19599,2482,2380,4862
3106002,4820,5184,10004,1252,1279,2531
3106101,1722,1681,3403,349,385,734
3106200,1113513,1261638,2375151,307842,324408,632250
3106309,11621,11776,23397,3208,3132,6340
3106408,3776,3760,7536,877,889,1766
3106507,6283,6017,12300,1984,1668,3652
3106606,2384,2114,4498,606,511,1117
3106655,2190,2180,4370,617,618,1235
3106705,186352,191737,378089,53821,54190,108011
3106804,1970,1823,3793,410,377,787
3106903,6558,7095,13653,1629,1572,3201
3107000,1320,1310,2630,255,288,543
3107109,19274,19242,38516,5048,4828,9876
3107208,2636,2371,5007,587,526,1113
3107307,23366,23288,46654,6678,6499,13177
3107406,22625,22999,45624,5978,5711,11689
3107505,3249,3252,6501,690,672,1362
3107604,2022,1865,3887,469,410,879
3107703,2709,2782,5491,747,722,1469
3107802,7824,7540,15364,1826,1781,3607
3107901,5444,5013,10457,1339,1251,2590
3108008,8551,8692,17243,1990,1978,3968
3108107,3423,3395,6818,675,633,1308
3108206,2977,2888,5865,745,674,1419
3108255,4995,4678,9673,1432,1338,2770
3108305,8671,8447,17118,2103,1990,4093
3108404,7472,7448,14920,1759,1736,3495
3108503,3395,3102,6497,978,865,1843
3108552,7384,6842,14226,2082,1965,4047
3108602,15591,15622,31213,4402,4283,8685
3108701,2322,2315,4637,502,500,1002
3108800,2463,2567,5030,586,555,1141
3108909,7433,7228,14661,1707,1662,3369
3109006,17023,16950,33973,4339,4235,8574
3109105,5660,5232,10892,1295,1156,2451
3109204,5166,5126,10292,1461,1331,2792
3109253,2030,1962,3992,484,468,952
3109303,11552,11185,22737,3025,2928,5953
3109402,13529,13393,26922,3812,3834,7646
3109451,3395,3058,6453,791,735,1526
3109501,7452,6371,13823,2109,1645,3754
3109600,1718,1936,3654,384,451,835
3109709,5767,5267,11034,1294,1164,2458
3109808,1254,1251,2505,284,307,591
3109907,5115,5103,10218,1373,1293,2666
3110004,19827,20923,40750,5162,5103,10265
3110103,2587,2381,4968,673,615,1288
3110202,2120,1927,4047,544,500,1044
3110301,6953,6680,13633,1478,1495,2973
3110400,1665,1489,3154,423,364,787
3110509,10857,10223,21080,2772,2636,5408
3110608,13233,13255,26488,3263,3209,6472
3110707,6222,6380,12602,1567,1478,3045
3110806,1734,1830,3564,424,473,897
3110905,7760,7673,15433,2015,1844,3859
3111002,10764,9922,20686,2479,2392,4871
3111101,9804,9520,19324,2243,2155,4398
3111150,1946,1738,3684,439,436,875
3111200,25144,26400,51544,6060,6105,12165
3111309,5829,5647,11476,1348,1370,2718
3111408,3679,3191,6870,968,885,1853
3111507,7263,6943,14206,2007,1795,3802
3111606,14064,13536,27600,3358,3330,6688
3111705,2374,2254,4628,606,556,1162
3111804,5984,5381,11365,1692,1426,3118
3111903,2861,2728,5589,704,635,1339
3112000,7457,7138,14595,1785,1624,3409
3112059,2045,2150,4195,589,590,1179
3112109,2743,2466,5209,759,672,1431
3112208,2333,2422,4755,502,551,1053
3112307,17145,17658,34803,4955,5127,10082
3112406,3741,3348,7089,974,801,1775
3112505,4414,4467,8881,1163,1139,2302
3112604,7824,7466,15290,1928,1776,3704
3112653,2419,2506,4925,559,615,1174
3112703,7203,7003,14206,2123,1964,4087
3112802,4168,4015,8183,971,918,1889
3112901,4640,4390,9030,1191,1075,2266
3113008,11299,11044,22343,3122,2853,5975
3113107,1677,1611,3288,415,376,791
3113206,11561,11785,23346,3101,2853,5954
3113305,15692,16604,32296,3959,3783,7742
3113404,41671,43568,85239,10700,11182,21882
3113503,4682,4466,9148,1296,1175,2471
3113602,3223,3075,6298,779,691,1470
3113701,10007,10062,20069,2522,2602,5124
3113800,1219,1227,2446,276,289,565
3113909,5976,5860,11836,1566,1519,3085
3114006,5452,5475,10927,1322,1232,2554
3114105,6895,6855,13750,1863,1762,3625
3114204,10030,9982,20012,2610,2431,5041
3114303,15052,14683,29735,3721,3382,7103
3114402,10483,9943,20426,2566,2415,4981
3114501,8761,8287,17048,2238,2143,4381
3114550,4867,4604,9471,1230,1090,2320
3114600,2011,1937,3948,466,438,904
3114709,1704,1637,3341,344,364,708
3114808,2340,2216,4556,560,507,1067
3114907,1152,1092,2244,297,252,549
3115003,1527,1330,2857,312,283,595
3115102,8800,8612,17412,2130,2056,4186
3115201,2063,1891,3954,527,459,986
3115300,34216,35541,69757,8425.081,8263.94,16689.02
3115359,2389,2457,4846,583,598,1181
3115409,1761,1701,3462,476,483,959
3115458,3363,3345,6708,950,912,1862
3115474,2627,2475,5102,669,659,1328
3115508,10526,11179,21705,2542,2546,5088
3115607,628,582,1210,121.5705,132.4295,254
3115706,3301,3471,6772,746,790,1536
3115805,5251,5015,10266,1263,1224,2487
3115904,1410,1382,2792,315,292,607
3116001,2863,2782,5645,725,708,1433
3116100,7446,7743,15189,2385,2348,4733
3116159,5636,5169,10805,1798,1606,3404
3116209,1355,1430,2785,303,316,619
3116308,3347,3200,6547,900,857,1757
3116407,2370,2172,4542,595,550,1145
3116506,3963,3812,7775,1069,976,2045
3116605,13088,12683,25771,3490.184,3083.641,6573.825
3116704,3547,3507,7054,811,809,1620
3116803,4480,4544,9024,1209,1232,2441
3116902,1591,1381,2972,428,339,767
3117009,4224,4074,8298,1076,1003,2079
3117108,5008,4812,9820,1199,1176,2375
3117207,1468,1281,2749,364,300,664
3117306,12049,10994,23043,3546,3120,6666
3117405,2242,2214,4456,477,492,969
3117504,9003,8905,17908,2456,2181,4637
3117603,2655,2503,5158,635,596,1231
3117702,6518,6431,12949,1606,1567,3173
3117801,5311,5077,10388,1360,1270,2630
3117836,3604,3497,7101,1002,933,1935
3117876,2923,3013,5936,754,784,1538
3117900,5405,5063,10468,1284,1216,2500
3118007,23834,24685,48519,6781,6599,13380
3118106,2482,2461,4943,636,622,1258
3118205,3316,3210,6526,881,775,1656
3118304,56383,60129,116512,15879,15363,31242
3118403,10754,11488,22242,2624,2701,5325
3118502,888,839,1727,185,193,378
3118601,292798,310644,603442,82974.27,84140.91,167115.2
3118700,4632,4657,9289,1101,1151,2252
3118809,13184,12849,26033,3660,3412,7072
3118908,4435,4232,8667,1174,1038,2212
3119005,1767,1668,3435,414,418,832
3119104,11760,12154,23914,2966,2849,5815
3119203,5225,5045,10270,1351,1313,2664
3119302,13957,13590,27547,3313,3188,6501
3119401,50035,53659,103694,13726,13797,27523
3119500,4658,4459,9117,1287,1205,2492
3119609,1516,1467,2983,369,335,704
3119708,1645,1656,3301,378,389,767
3119807,1789,1602,3391,370,335,705
3119906,1948,1782,3730,392,350,742
3119955,2983,2807,5790,742,723,1465
3120003,1555,1572,3127,364,370,734
3120102,2103,2101,4204,570,556,1126
3120151,3080,2967,6047,812,771,1583
3120201,5765,5521,11286,1470,1410,2880
3120300,2911,2849,5760,902.4173,913.0745,1815.492
3120409,2516,2491,5007,650,604,1254
3120508,5224,4986,10210,1283,1223,2506
3120607,2430,2327,4757,539,543,1082
3120706,2008,1926,3934,485,486,971
3120805,7245,7346,14591,1811,1781,3592
3120839,2355,2325,4680,593,589,1182
3120870,3500,3413,6913,934,901,1835
3120904,36141,38078,74219,9698,9746,19444
3121001,2551,2660,5211,704,690,1394
3121100,4188,3783,7971,1023,857,1880
3121209,3550,3280,6830,817,767,1584
3121258,4538,3551,8089,1515,1066,2581
3121308,2408,2360,4768,612,606,1218
3121407,3571,3431,7002,865,736,1601
3121506,1546,1469,3015,349,327,676
3121605,22239,23641,45880,6612,6832,13444
3121704,1930,1918,3848,436,405,841
3121803,4301,4438,8739,1156,1051,2207
3121902,1655,1638,3293,431,396,827
3122009,9681,9452,19133,2387,2328,4715
3122108,2460,2477,4937,589,559,1148
3122207,3479,3545,7024,1023,956,1979
3122306,103828,109188,213016,27824,27535,55359
3122355,2905,2979,5884,820,824,1644
3122405,2982,2781,5763,711,711,1422
3122454,4659,4315,8974,1329,1231,2560
3122470,2022,1792,3814,524,454,978
3122504,2536,2673,5209,582,595,1177
3122603,2222,2313,4535,556,530,1086
3122702,2493,2703,5196,529,562,1091
3122801,1544,1450,2994,324,335,659
3122900,3038,2963,6001,770,733,1503
3123007,4614,4685,9299,1151,1103,2254
3123106,2612,2611,5223,594,635,1229
3123205,6715,7063,13778,1490,1386,2876
3123304,2297,2165,4462,522,488,1010
3123403,747,693,1440,133.1873,169.3224,302.5096
3123502,970,871,1841,233,194,427
3123528,3770,3653,7423,1071,957,2028
3123601,12489,12731,25220,3126,3126,6252
3123700,4960,5320,10280,1255,1332,2587
3123809,3618,3504,7122,950,921,1871
3123858,2570,2605,5175,619,617,1236
3123908,7069,7173,14242,1773,1749,3522
3124005,8990,8956,17946,2415,2405,4820
3124104,30270,30001,60271,7880,7636,15516
3124203,11504,11352,22856,2973,2937,5910
3124302,15291,15822,31113,4552,4561,9113
3124401,2342,2087,4429,550,450,1000
3124500,5609,5236,10845,1412,1238,2650
3124609,1233,1237,2470,303,292,595
3124708,1769,1747,3516,375,353,728
3124807,3899,3547,7446,988,902,1890
3124906,5318,5222,10540,1331,1251,2582
3125002,1855,1898,3753,464,507,971
3125101,14414,14185,28599,4110,3789,7899
3125200,1180,1170,2350,247,238,485
3125309,1714,1662,3376,423,354,777
3125408,2568,2574,5142,622,622,1244
3125507,1481,1575,3056,400,406,806
3125606,3506,3371,6877,889,792,1681
3125705,7046,7075,14121,1738,1753,3491
3125804,1549,1481,3030,377,372,749
3125903,5395,5442,10837,1173,1210,2383
3125952,5329,5020,10349,1430,1334,2764
3126000,3245,3355,6600,810,865,1675
3126109,32137,32991,65128,8304,7844,16148
3126208,4283,3894,8177,1249,1151,2400
3126307,2101,1997,4098,430.8017,506.8886,937.6903
3126406,1394,1311,2705,351,327,678
3126505,5279,4969,10248,1678,1447,3125
3126604,2535,2328,4863,648,626,1274
3126703,12942,11970,24912,3656,3208,6864
3126752,2970,2830,5800,723,740,1463
3126802,2968,2911,5879,742,748,1490
3126901,4355,4565,8920,1119,1152,2271
3126950,1688,1641,3329,469,428,897
3127008,7230,6811,14041,2018,1881,3899
3127057,2389,2298,4687,583,561,1144
3127073,3024,2916,5940,814,747,1561
3127107,27073,26395,53468,7412,6765,14177
3127206,1958,1897,3855,461,482,943
3127305,3405,3546,6951,797,780,1577
3127339,2624,2515,5139,749,685,1434
3127354,1496,1466,2962,366,364,730
3127370,1486,1567,3053,357,384,741
3127388,1845,1814,3659,406,356,762
3127404,2192,2028,4220,444,443,887
3127503,2927,2994,5921,788,823,1611
3127602,5662,6019,11681,1620,1658,3278
3127701,125237,138452,263689,34144.77,35537.48,69682.25
3127800,7727,7297,15024,2308,2122,4430
3127909,714,659,1373,146.9125,160.0875,307
3128006,15201,16061,31262,4216,4264,8480
3128105,7281,6591,13872,1731,1644,3375
3128204,5174,5049,10223,1305,1241,2546
3128253,2378,2340,4718,645,612,1257
3128303,9498,9216,18714,2556,2330,4886
3128402,4423,4255,8678,1123,1030,2153
3128501,1950,1979,3929,487,467,954
3128600,3427,3138,6565,872,773,1645
3128709,24619,24811,49430,6449,6125,12574
3128808,3638,3568,7206,897,844,1741
3128907,3713,3552,7265,913,883,1796
3129004,4427,4280,8707,1006,987,1993
3129103,3237,2900,6137,573,544,1117
3129202,3117,3004,6121,695,736,1431
3129301,5132,5183,10315,1313,1276,2589
3129400,2543,2493,5036,606,611,1217
3129509,11858,11360,23218,3092,2793,5885
3129608,4034,3805,7839,1142,1051,2193
3129657,3218,2937,6155,888,806,1694
3129707,6364,5812,12176,1720,1572,3292
3129806,77839,81115,158954,22081,22655,44736
3129905,1760,1622,3382,394,385,779
3130002,1448,1418,2866,333,332,665
3130051,5567,5179,10746,1869,1643,3512
3130101,17520,17331,34851,4701,4578,9279
3130200,4773,4491,9264,1361,1222,2583
3130309,4034,3995,8029,1089,989,2078
3130408,2964,2895,5859,742,769,1511
3130507,5860,5628,11488,1497,1430,2927
3130556,3293,3131,6424,832,800,1632
3130606,3521,3387,6908,844,779,1623
3130655,3735,3595,7330,1026,950,1976
3130705,3231,2959,6190,865,809,1674
3130804,1391,1238,2629,339,296,635
3130903,12129,12165,24294,2816,2917,5733
3131000,2909,2851,5760,806,743,1549
3131109,3329,3395,6724,875,876,1751
3131158,8411,8297,16708,2436,2194,4630
3131208,8806,9364,18170,2135,2216,4351
3131307,116209,123259,239468,33038,33636,66674
3131406,2096,2011,4107,510,477,987
3131505,4937,4584,9521,1221,1101,2322
3131604,3381,3086,6467,867,809,1676
3131703,52733,57050,109783,14452,14815,29267
3131802,5322,5370,10692,1366,1350,2716
3131901,22337,23112,45449,6168,6072,12240
3132008,2678,2310,4988,794,666,1460
3132107,8842,8878,17720,2566,2409,4975
3132206,6267,6105,12372,1500,1452,2952
3132305,6015,5783,11798,1727,1644,3371
3132404,44489,46169,90658,12318,11813,24131
3132503,16144,16031,32175,4695,4540,9235
3132602,2104,1975,4079,512,501,1013
3132701,11032,11777,22809,2917,2991,5908
3132800,1179,1104,2283,313,233,546
3132909,5306,5043,10349,1360,1242,2602
3133006,7086,6917,14003,1839,1761,3600
3133105,6947,7228,14175,1800,1784,3584
3133204,5799,6057,11856,1523.332,1429.3,2952.632
3133303,10493,10508,21001,2711,2678,5389
3133402,7124,6532,13656,1953,1659,3612
3133501,10603,10774,21377,2470,2436,4906
3133600,4498,4166,8664,1149,1077,2226
3133709,5043,4885,9928,1272,1231,2503
3133758,7403,7542,14945,1904,1823,3727
3133808,42099,43364,85463,11311,10902,22213
3133907,2977,2822,5799,759,717,1476
3134004,7352,7055,14407,1956,1819,3775
3134103,2962,2868,5830,667,639,1306
3134202,47862,49309,97171,12140,11743,23883
3134301,3059,3080,6139,774,765,1539
3134400,17297,17159,34456,4828,4572,9400
3134509,1995,1918,3913,481,441,922
3134608,8705,8429,17134,2111,1981,4092
3134707,6285,5849,12134,1537,1387,2924
3134806,3873,3629,7502,908,849,1757
3134905,11334,11438,22772,3060,2915,5975
3135001,1508,1482,2990,411,377,788
3135050,17344,16243,33587,5460,5245,10705
3135076,2594,2473,5067,656,610,1266
3135100,32795,34008,66803,9589,9858,19447
3135209,32344,33119,65463,8699.74,8980.538,17680.28
3135308,2012,1927,3939,561,511,1072
3135357,4211,4087,8298,1253,1132,2385
3135407,2723,2672,5395,667,602,1269
3135456,3662,3454,7116,1220,1040,2260
3135506,6477,6371,12848,1598,1474,3072
3135605,4031,3974,8005,1079,1068,2147
3135704,2665,2491,5156,658,621,1279
3135803,12276,11855,24131,2953,2822,5775
3135902,2469,2299,4768,597,531,1128
3136009,7503,7438,14941,1930,1755,3685
3136108,2699,2726,5425,643,557,1200
3136207,35049,38561,73610,9045,9336,18381
3136306,23048,22212,45260,6295,6017,12312
3136405,2216,2089,4305,593,542,1135
3136504,5334,4990,10324,1393,1307,2700
3136520,2358,2195,4553,778,687,1465
3136553,2220,2156,4376,552,544,1096
3136579,2346,2220,4566,707,548,1255
3136603,2796,2759,5555,705,677,1382
3136652,11217,10985,22202,3087,3028,6115
3136702,244024,272223,516247,65202,66718,131920
3136801,2053,2060,4113,541,542,1083
3136900,4703,4535,9238,1279,1332,2611
3136959,2923,2785,5708,802,780,1582
3137007,8392,8602,16994,2305,2223,4528
3137106,3917,3683,7600,854,747,1601
3137205,22852,23132,45984,6182,5926,12108
3137304,2201,2024,4225,619,588,1207
3137403,6347,5909,12256,1717,1519,3236
3137502,8652,8509,17161,1996,1955,3951
3137536,4549,4082,8631,1210,1045,2255
3137601,25735,26785,52520,6742,6624,13366
3137700,9828,9781,19609,2656,2602,5258
3137809,9640,9914,19554,2348,2246,4594
3137908,1745,1707,3452,371,399,770
3138005,3254,3211,6465,762,752,1514
3138104,3327,3157,6484,874,783,1657
3138203,44721,47479,92200,12277,12152,24429
3138302,1640,1565,3205,422,400,822
3138351,2395,2409,4804,758,697,1455
3138401,24546,26584,51130,6052,6211,12263
3138500,2701,2645,5346,568,546,1114
3138609,8141,8008,16149,1830,1789,3619
3138625,3532,3358,6890,974,913,1887
3138658,4370,4027,8397,1263,1104,2367
3138674,3224,3010,6234,874,781,1655
3138682,3293,3107,6400,934,855,1789
3138708,2811,2611,5422,626,639,1265
3138807,8716,8770,17486,2205,2109,4314
3138906,3609,3367,6976,885,815,1700
3139003,19342,19346,38688,5178,4979,10157
3139102,2463,2441,4904,574,576,1150
3139201,9159,9617,18776,2415,2425,4840
3139250,3183,3138,6321,782,712,1494
3139300,9794,10019,19813,2673,2589,5262
3139409,39190,40384,79574,10531,10782,21313
3139508,10518,10864,21382,2657,2647,5304
3139607,13087,14024,27111,3186,3385,6571
3139706,3631,3532,7163,949,951,1900
3139805,5712,6037,11749,1480,1445,2925
3139904,7202,7014,14216,1829,1782,3611
3140001,26583,27636,54219,7937.705,7762.369,15700.07
3140100,2059,2160,4219,545,556,1101
3140159,6641,6551,13192,1850,1749,3599
3140209,1389,1399,2788,336,311,647
3140308,1997,2015,4012,466,476,942
3140407,1491,1477,2968,367,372,739
3140506,6373,6238,12611,1594,1481,3075
3140530,3656,3517,7173,990,962,1952
3140555,4141,3733,7874,1153,979,2132
3140605,2285,2310,4595,628,575,1203
3140704,13813,14043,27856,3653,3624,7277
3140803,6692,6743,13435,1654,1623,3277
3140852,5096,4883,9979,1557,1406,2963
3140902,8727,8912,17639,2298,2333,4631
3141009,6260,6424,12684,1745,1699,3444
3141108,16758,17197,33955,4709,4670,9379
3141207,1852,1909,3761,389,380,769
3141306,1811,1633,3444,413,393,806
3141405,10476,10550,21026,2566,2660,5226
3141504,3153,3178,6331,729,716,1445
3141603,5156,5212,10368,1217,1224,2441
3141702,3029,3040,6069,742,735,1477
3141801,15350,15444,30794,5154,4759,9913
3141900,1889,1951,3840,452,459,911
3142007,6629,6413,13042,1818,1753,3571
3142106,5234,5017,10251,1306,1253,2559
3142205,6944,6864,13808,1827,1687,3514
3142254,2283,2266,4549,581,624,1205
3142304,2343,2346,4689,498,487,985
3142403,3553,3475,7028,903,859,1762
3142502,1207,1153,2360,279,292,571
3142601,4180,3981,8161,1080,979,2059
3142700,7996,7866,15862,2115,1920,4035
3142809,10052,9567,19619,2486,2220,4706
3142908,10839,11155,21994,2797,2795,5592
3143005,6810,6251,13061,1713,1508,3221
3143104,23066,22706,45772,5971,5658,11629
3143153,2431,2225,4656,606,530,1136
3143203,10686,10548,21234,2632,2428,5060
3143302,174249,187666,361915,51904,55022,106926
3143401,10654,10549,21203,2824,2766,5590
3143450,3775,3689,7464,1084,1005,2089
3143500,4205,4050,8255,1002,925,1927
3143609,1376,1284,2660,343,354,697
3143708,1709,1690,3399,424,389,813
3143807,3247,3010,6257,821,757,1578
3143906,48757,52008,100765,12792,13278,26070
3144003,13475,13186,26661,3344,3221,6565
3144102,10266,10164,20430,2556,2417,4973
3144201,1586,1568,3154,407,350,757
3144300,19994,20840,40834,5162,5229,10391
3144359,3194,3147,6341,909,867,1776
3144375,1736,1544,3280,469,400,869
3144409,2409,2249,4658,500,494,994
3144508,4118,3836,7954,965,899,1864
3144607,12832,12901,25733,3255,3224,6479
3144656,5053,4762,9815,1443,1287,2730
3144672,1897,1835,3732,407,461,868
3144706,8349,9179,17528,2235,2358,4593
3144805,39151,41847,80998,10709,10652,21361
3144904,1903,1887,3790,488,449,937
3145000,6725,6087,12812,1849,1707,3556
3145059,3788,3610,7398,1140,1057,2197
3145109,8106,7268,15374,2090,1870,3960
3145208,38067,35632,73699,14234,12598,26832
3145307,15256,15469,30725,4293,4189,8482
3145356,5296,5043,10339,1397,1303,2700
3145372,2489,2474,4963,694,594,1288
3145406,1060,916,1976,222,183,405
3145455,2778,2489,5267,795,708,1503
3145505,1304,1229,2533,294,271,565
3145604,19305,20161,39466,4807,4801,9608
3145703,1080,1043,2123,250,248,498
3145802,1558,1497,3055,371,337,708
3145851,2234,2259,4493,573,576,1149
3145877,3697,3587,7284,964,958,1922
3145901,17577,17691,35268,5332,5190,10522
3146008,15818,15750,31568,3826,3604,7430
3146107,34277,36004,70281,9550,9357,18907
3146206,3018,2998,6016,785,756,1541
3146255,2973,2861,5834,931,808,1739
3146305,9334,9515,18849,2340,2519,4859
3146404,2332,2299,4631,496,458,954
3146503,4026,3988,8014,938,944,1882
3146552,3024,2910,5934,884,806,1690
3146602,782,776,1558,156.7864,172.2136,329
3146701,3313,3232,6545,794,712,1506
3146750,3570,3361,6931,951,809,1760
3146909,7237,6938,14175,1947,1837,3784
3147006,42470,42248,84718,12415,12142,24557
3147105,41639,42576,84215,11456,11022,22478
3147204,10178,10067,20245,2629,2511,5140
3147303,9785,9594,19379,2391,2284,4675
3147402,11132,11431,22563,3097,3030,6127
3147501,865,901,1766,213,222,435
3147600,7727,7855,15582,1931,1797,3728
3147709,4133,4064,8197,1004,890,1894
3147808,1089,990,2079,242,221,463
3147907,52568,53722,106290,13620,13453,27073
3147956,2918,2661,5579,835,744,1579
3148004,67924,70786,138710,17895,17669,35564
3148103,41939,40532,82471,11190,10426,21616
3148202,2650,2637,5287,629,594,1223
3148301,4693,4578,9271,1263,1170,2433
3148400,2385,2533,4918,596,601,1197
3148509,4346,4243,8589,1158,1037,2195
3148608,8525,8735,17260,2375,2343,4718
3148707,11744,12095,23839,3118,3088,6206
3148756,3455,3218,6673,886,914,1800
3148806,1681,1684,3365,383,377,760
3148905,1986,1889,3875,446,429,875
3149002,1136,1055,2191,280,265,545
3149101,5858,5609,11467,1430,1308,2738
3149150,5293,5022,10315,1549,1419,2968
3149200,1798,1692,3490,398,409,807
3149309,28746,29994,58740,7783.428,7696.907,15480.33
3149408,948,837,1785,204,197,401
3149507,1563,1602,3165,424,383,807
3149606,2042,2034,4076,480,478,958
3149705,4555,4357,8912,1356,1216,2572
3149804,7533,6871,14404,1931,1840,3771
3149903,9875,10212,20087,2484,2466,4950
3149952,3452,3584,7036,875,871,1746
3150000,2045,2083,4128,539,551,1090
3150109,1490,1351,2841,327,264.1333,591.1334
3150158,3649,3461,7110,937,921,1858
3150208,1992,2070,4062,555,545,1100
3150307,2390,2319,4709,453,463,916
3150406,2417,2223,4640,569.736,402.248,971.9841
3150505,4243,3993,8236,1038,978,2016
3150539,2199,2221,4420,549,526,1075
3150570,3778,3433,7211,1092,888,1980
3150604,3233,3173,6406,716,710,1426
3150703,2545,2111,4656,730,598,1328
3150802,8648,8584,17232,2460,2203,4663
3150901,2702,2515,5217,635,609,1244
3151008,4066,3950,8016,1001,973,1974
3151107,5105,5259,10364,1310,1304,2614
3151206,26146,27222,53368,7481,7456,14937
3151305,5439,5423,10862,1326,1324,2650
3151404,12546,12765,25311,3373,3184,6557
3151503,15850,16033,31883,4061,3891,7952
3151602,5451,4933,10384,1619,1313,2932
3151701,8213,7746,15959,1885,1792,3677
3151800,73680,78755,152435,19209,19170,38379
3151909,4515,4471,8986,1061,1013,2074
3152006,14638,14467,29105,3988,3861,7849
3152105,27495,29895,57390,7200,7233,14433
3152131,2019,1947,3966,582,563,1145
3152170,5797,5548,11345,1422,1328,2750
3152204,18828,18799,37627,5424,5204,10628
3152303,5303,5114,10417,1358,1298,2656
3152402,7719,7948,15667,1949,1939,3888
3152501,64519,66096,130615,17629,17066,34695
3152600,3135,3078,6213,726,691,1417
3152709,4212,4179,8391,1041,950,1991
3152808,13273,12529,25802,3358,3181,6539
3152907,4456,4351,8807,1002,866,1868
3153004,1699,1566,3265,391,325,716
3153103,2780,2757,5537,578,585,1163
3153202,1996,1912,3908,487,461,948
3153301,1493,1466,2959,403,401,804
3153400,9533,9044,18577,2245,2188,4433
3153509,4249,4069,8318,1006,998,2004
3153608,4736,4837,9573,1312,1375,2687
3153707,1683,1620,3303,403,346,749
3153806,957,904,1861,182.5234,179.4766,362
3153905,7386,7956,15342,2119,2125,4244
3154002,11729,12089,23818,2624,2709,5333
3154101,5000,5299,10299,1111,1132,2243
3154150,3380,3189,6569,916,855,1771
3154200,5373,5540,10913,1318,1303,2621
3154309,8369,8720,17089,1957,2004,3961
3154408,2349,2362,4711,577,554,1131
3154457,4182,3825,8007,1147,957,2104
3154507,4755,4605,9360,1490,1330,2820
3154606,146982,149335,296317,43054,41424,84478
3154705,1842,1984,3826,471,459,930
3154804,4469,4621,9090,1236,1268,2504
3154903,6848,7353,14201,1726,1775,3501
3155009,1229,1236,2465,314,270,584
3155108,2677,2540,5217,691,647,1338
3155207,3069,3001,6070,644,674,1318
3155306,2773,2503,5276,660,573,1233
3155405,4373,4339,8712,1064,1043,2107
3155504,6091,5794,11885,1627,1492,3119
3155603,14832,14267,29099,4361,4012,8373
3155702,6915,7234,14149,1740,1688,3428
3155801,8509,8601,17110,2233,2145,4378
3155900,2671,2621,5292,594,566,1160
3156007,6722,6923,13645,1686,1728,3414
3156106,2434,2491,4925,561,514,1075
3156205,1086,1030,2116,252,244,496
3156304,3458,3409,6867,927,971,1898
3156403,1867,1729,3596,450,416,866
3156452,2183,2064,4247,583,551,1134
3156502,3999,3773,7772,972,892,1864
3156601,5062,4857,9919,1233,1192,2425
3156700,60828,65441,126269,16950,17065,34015
3156809,7775,7929,15704,1969,2022,3991
3156908,12129,11767,23896,3229,3000,6229
3157005,19274,19904,39178,5152,5376,10528
3157104,3506,3353,6859,904,831,1735
3157203,13670,14206,27876,3872,3871,7743
3157252,3922,3760,7682,961,941,1902
3157278,1455,1333,2788,312,288,600
3157302,2323,2247,4570,555,544,1099
3157336,3854,4011,7865,1029,1044,2073
3157377,2274,2123,4397,549,480,1029
3157401,2508,2484,4992,573,553,1126
3157500,2265,2335,4600,583,645,1228
3157609,2088,1880,3968,541,513,1054
3157658,3056,2999,6055,814,741,1555
3157708,5831,5506,11337,1689,1485,3174
3157807,98485,104457,202942,27342,27928,55270
3157906,7583,7428,15011,2042,1951,3993
3158003,5236,5316,10552,1409,1387,2796
3158102,2719,2565,5284,745,652,1397
3158201,7154,7241,14395,1972,1825,3797
3158300,3625,3606,7231,899,893,1792
3158409,1818,1804,3622,387,389,776
3158508,4129,3880,8009,906,861,1767
3158607,1947,1913,3860,459,451,910
3158706,1171,1063,2234,294,253,547
3158805,2319,2288,4607,570,526,1096
3158904,4393,4189,8582,1110,1048,2158
3158953,13663,13602,27265,3681,3650,7331
3159001,2018,2005,4023,462,501,963
3159100,1961,1861,3822,420,429,849
3159209,4603,4424,9027,965,959,1924
3159308,2536,2457,4993,528,549,1077
3159357,3297,3250,6547,888,836,1724
3159407,1846,1737,3583,412,374,786
3159506,2929,2768,5697,694,672,1366
3159605,18863,18891,37754,5365,4827,10192
3159704,1691,1533,3224,412,365,777
3159803,9408,8730,18138,2252,2053,4305
3159902,8587,8758,17345,2248,2239,4487
3160009,1808,1730,3538,365,379,744
3160108,2033,2052,4085,496,493,989
3160207,2068,2067,4135,535,527,1062
3160306,6027,5748,11775,1481,1410,2891
3160405,13197,12778,25975,3544,3203,6747
3160454,3526,3429,6955,975,935,1910
3160504,889,888,1777,205,220,425
3160603,1621,1617,3238,370,382,752
3160702,22496,23788,46284,5722,5549,11271
3160801,2385,2192,4577,636,585,1221
3160900,1730,1783,3513,447,433,880
3160959,2748,2660,5408,792,777,1569
3161007,8440,8917,17357,1963,2062,4025
3161056,1734,1648,3382,436,439,875
3161106,27278,26550,53828,7882,7408,15290
3161205,3280,3203,6483,857,829,1686
3161304,2972,2804,5776,755,726,1481
3161403,2655,2523,5178,632,573,1205
3161502,5218,5045,10263,1374,1278,2652
3161601,2136,2253,4389,571,568,1139
3161650,1760,1726,3486,436,399,835
3161700,3241,3023,6264,793,762,1555
3161809,5227,5171,10398,1318,1255,2573
3161908,4872,4905,9777,1360,1312,2672
3162005,11924,11982,23906,3102,3025,6127
3162104,16096,15723,31819,4674,4349,9023
3162203,3558,3329,6887,882,806,1688
3162252,2438,2218,4656,669,613,1282
3162302,1400,1331,2731,327,331,658
3162401,13123,12235,25358,3838,3395,7233
3162450,6048,5667,11715,1795,1714,3509
3162500,40549,43920,84469,10110,10209,20319
3162559,5214,5031,10245,1458,1395,2853
3162575,2555,2633,5188,593,622,1215
3162609,3907,3967,7874,996,947,1943
3162658,2092,1968,4060,529,543,1072
3162708,11163,11156,22319,3436,3287,6723
3162807,7614,7939,15553,1989,2000,3989
3162906,12181,12876,25057,3003,3008,6011
3162922,13741,11796,25537,4347,3168,7515
3162948,3509,3269,6778,889,836,1725
3162955,9826,9973,19799,2642,2583,5225
3163003,2027,2048,4075,580,539,1119
3163102,2133,2065,4198,529,511,1040
3163201,1976,2020,3996,437,470,907
3163300,1890,1944,3834,505,500,1005
3163409,2732,2904,5636,648,696,1344
3163508,3331,3222,6553,945,775,1720
3163607,1291,1301,2592,301,288,589
3163706,19758,21899,41657,4854,5048,9902
3163805,3436,3324,6760,888,850,1738
3163904,2647,2393,5040,632,535,1167
3164001,4127,4229,8356,1015,981,1996
3164100,2746,2824,5570,754,684,1438
3164209,5239,5037,10276,1499,1511,3010
3164308,3483,3203,6686,818,723,1541
3164407,2579,2369,4948,632,569,1201
3164431,1459,1339,2798,362,320,682
3164472,2923,2816,5739,806,769,1575
3164506,5371,5276,10647,1293,1247,2540
3164605,3030,2775,5805,883,724,1607
3164704,32182,32798,64980,8471,8110,16581
3164803,772,841,1613,150.619,159.381,310
3164902,1048,1062,2110,238,240,478
3165008,5300,5261,10561,1279,1260,2539
3165107,3558,3535,7093,904,831,1735
3165206,3539,3116,6655,883,745,1628
3165305,3394,3614,7008,839,878,1717
3165404,3204,3037,6241,769,752,1521
3165503,2814,2780,5594,763,755,1518
3165537,12871,12943,25814,3381.319,3354.906,6736.225
3165552,5350,5535,10885,1449,1475,2924
3165560,1404,1443,2847,308,327,635
3165578,2776,2443,5219,749,629,1378
3165602,985,1003,1988,217.4667,244,461.4667
3165701,3653,3577,7230,842,838,1680
3165800,1004,864,1868,206,160,366
3165909,2317,2257,4574,600,571,1171
3166006,2848,2835,5683,675,704,1379
3166105,1765,1732,3497,423,377,800
3166204,5152,5044,10196,1249,1235,2484
3166303,3647,3481,7128,1000,914,1914
3166402,918,871,1789,225,205,430
3166501,2121,2099,4220,579,571,1150
3166600,430,385,815,111.2791,76.2728,187.5519
3166709,4172,4240,8412,1074,990,2064
3166808,5422,5127,10549,1487,1351,2838
3166907,3803,3739,7542,939,940,1879
3166956,2231,2194,4425,601,566,1167
3167004,999,996,1995,253,260,513
3167103,10374,10461,20835,2843,2700,5543
3167202,103991,110161,214152,29494,29525,59019
3167301,1148,1044,2192,267,262,529
3167400,3128,2899,6027,719,658,1377
3167509,1248,1289,2537,307,286,593
3167608,9466,8832,18298,2527,2389,4916
3167707,2857,2973,5830,640,657,1297
3167806,2839,2837,5676,669,673,1342
3167905,2047,2032,4079,459,458,917
3168002,15117,15800,30917,4207,4385,8592
3168051,1616,1521,3137,381,332,713
3168101,2214,1898,4112,605,517,1122
3168200,1002,871,1873,216,197,413
3168309,2027,1767,3794,475,417,892
3168408,7102,7191,14293,1629,1619,3248
3168507,5543,5812,11355,1334,1390,2724
3168606,64466,70279,134745,17214,18199,35413
3168705,39193,42050,81243,10620,10801,21421
3168804,3440,3521,6961,898,854,1752
3168903,3537,3369,6906,759,694,1453
3169000,7894,7929,15823,1937,1938,3875
3169059,2144,1806,3950,476,404,880
3169109,3043,2721,5764,720,625,1345
3169208,4783,4754,9537,1017.919,1104.191,2122.11
3169307,36103,36662,72765,9759,9421,19180
3169356,14074,14244,28318,3757,3676,7433
3169406,26705,27155,53860,6856,6816,13672
3169505,3198,3095,6293,794,729,1523
3169604,12084,12104,24188,2827,2683,5510
3169703,9168,8887,18055,2805,2627,5432
3169802,2409,2249,4658,578,592,1170
3169901,50258,51261,101519,13708,13394,27102
3170008,5979,5702,11681,1671,1549,3220
3170057,6085,5955,12040,1479,1538,3017
3170107,144461,151527,295988,39784,38470,78254
3170206,294914,309099,604013,83252,82639,165891
3170305,1399,1306,2705,347,333,680
3170404,39305,38260,77565,10613,10295,20908
3170438,2412,2006,4418,619,518,1137
3170479,1627,1608,3235,385,388,773
3170503,5085,5206,10291,1392,1330,2722
3170529,7030,6574,13604,1927,1905,3832
3170578,3295,3166,6461,785,739,1524
3170602,1145,1018,2163,273,235,508
3170651,2428,2305,4733,705,674,1379
3170701,59957,63124,123081,16077,16159,32236
3170750,3170,2884,6054,863,853,1716
3170800,18150,17659,35809,5162,5129,10291
3170909,9765,9351,19116,2886,2588,5474
3171006,9929,9794,19723,2486,2421,4907
3171030,4274,4072,8346,1310,1247,2557
3171071,2891,2658,5549,867,774,1641
3171105,1778,1705,3483,412,394,806
3171154,2427,2262,4689,577,565,1142
3171204,51006,53521,104527,14313,14998,29311
3171303,35001,37219,72220,10040,10423,20463
3171402,1900,1831,3731,494,447,941
3171501,1675,1695,3370,467,452,919
3171600,6763,6856,13619,1990,1833,3823
3171709,4308,4315,8623,1019,1033,2052
3171808,5215,5357,10572,1353,1337,2690
3171907,2788,2870,5658,704,669,1373
3172004,18701,19241,37942,5064,4878,9942
3172103,2477,2593,5070,635,628,1263
3172202,1288,1265,2553,260,314,574
3200102,15687,15404,31091,3985,3796,7781
3200136,4901,4618,9519,1195,1162,2357
3200169,5960,5811,11771,1503,1419,2922
3200201,15287,15481,30768,3945,3906,7851
3200300,7103,6852,13955,1693,1659,3352
3200359,3674,3643,7317,907,935,1842
3200409,12062,11840,23902,3223,3221,6444
3200508,3778,3734,7512,947,899,1846
3200607,40795,41037,81832,11712,11551,23263
3200706,4999,4851,9850,1344,1300,2644
3200805,14220,14861,29081,3432,3571,7003
3200904,20408,20241,40649,5338,5122,10460
3201001,7179,7020,14199,1930,1787,3717
3201100,4584,4892,9476,1144,1210,2354
3201159,6211,5704,11915,1756,1606,3362
3201209,92845,97044,189889,24836,25257,50093
3201308,169958,178780,348738,47846,48336,96182
3201407,17401,17346,34747,4464,4347,8811
3201506,54291,57497,111788,14746,14762,29508
3201605,14161,14288,28449,3840,3871,7711
3201704,5938,5743,11681,1511,1498,3009
3201803,2350,2166,4516,597,574,1171
3201902,16094,15753,31847,4161,4059,8220
3202009,3226,3171,6397,845,838,1683
3202108,11566,11646,23212,2797,2788,5585
3202207,8489,8536,17025,2145,2091,4236
3202256,5674,5195,10869,1465,1307,2772
3202306,13686,14165,27851,3584,3598,7182
3202405,51494,53792,105286,13549,13675,27224
3202454,11288,11078,22366,3040,2912,5952
3202504,5534,5644,11178,1532,1515,3047
3202553,4649,4308,8957,1213,1163,2376
3202603,6409,6114,12523,1671,1572,3243
3202652,6030,5693,11723,1584,1506,3090
3202702,7197,6937,14134,1745,1546,3291
3202801,15535,15453,30988,4014,4002,8016
3202900,5456,5425,10881,1395,1314,2709
3203007,13640,13688,27328,3747,3644,7391
3203056,12468,12210,24678,3608,3525,7133
3203106,5292,5587,10879,1287,1349,2636
3203130,7811,7998,15809,2048,2017,4065
3203163,5524,5302,10826,1345,1181,2526
3203205,70415,70891,141306,20279,19785,40064
3203304,6805,6807,13612,1665,1656,3321
3203320,16876,17264,34140,4272,4380,8652
3203346,7260,7002,14262,1901,1807,3708
3203353,5572,5535,11107,1426,1396,2822
3203403,13041,12861,25902,3284,3171,6455
3203502,8974,8875,17849,2352,2152,4504
3203601,2871,2784,5655,761,663,1424
3203700,9303,9094,18397,2469,2361,4830
3203809,7256,7140,14396,1848,1809,3657
3203908,23111,22920,46031,6204,5967,12171
3204005,11001,10547,21548,2775,2720,5495
3204054,11901,11893,23794,3258,3290,6548
3204104,12005,11890,23895,3246,3102,6348
3204203,8956,9167,18123,2363,2307,4670
3204252,3493,3486,6979,833,816,1649
3204302,5258,5056,10314,1372,1373,2745
3204351,9079,8451,17530,2473,2252,4725
3204401,5737,5588,11325,1469,1465,2934
3204500,6425,5815,12240,1600.147,1500.466,3100.613
3204559,17532,16644,34176,5119,4742,9861
3204609,10915,10908,21823,2735,2664,5399
3204658,4164,3837,8001,1059,986,2045
3204708,15905,15954,31859,4529,4394,8923
3204807,5195,5213,10408,1201,1167,2368
3204906,53930,55098,109028,15124,15236,30360
3204955,5688,5585,11273,1391,1368,2759
3205002,201415,207852,409267,59082.74,59102.88,118185.6
3205010,12133,11710,23843,3456,3333,6789
3205036,9827,9303,19130,2529,2441,4970
3205069,10335,10112,20447,2835,2765,5600
3205101,33191,31810,65001,10226,8806,19032
3205150,4493,4179,8672,1159,1154,2313
3205176,7208,6622,13830,1972,1741,3713
3205200,199146,215440,414586,54851,55684,110535
3205309,153948,173853,327801,43258,45523,88781
3300100,84666,84845,169511,21989.45,22601.58,44591.03
3300159,5023,5190,10213,1225,1250,2475
3300209,54283,57725,112008,13275,13534,26809
3300225,5661,5762,11423,1442,1430,2872
3300233,13742,13818,27560,3349,3545,6894
3300258,13627,14088,27715,3171,3158,6329
3300308,45154,49624,94778,10971.3,11455.91,22427.21
3300407,85792,92021,177813,21584,22343,43927
3300456,226757,242575,469332,59701,61422,121123
3300506,12720,12613,25333,3151,3053,6204
3300605,17196,18215,35411,4143,4116,8259
3300704,90831,95396,186227,23024,23779,46803
3300803,27062,27211,54273,6823,6712,13535
3300902,7407,7420,14827,1603,1618,3221
3300936,6788,6571,13359,1718,1695,3413
3300951,4076,4104,8180,987,942,1929
3301009,223259,240472,463731,59064,59890,118954
3301108,9831,9999,19830,2386,2318,4704
3301157,6270,6330,12600,1503,1463,2966
3301207,8600,8834,17434,1980,2031,4011
3301306,17423,17924,35347,4608,4449,9057
3301405,10549,10662,21211,2693,2605,5298
3301504,9781,10649,20430,2411,2536,4947
3301603,5511,5419,10930,1377,1378,2755
3301702,411074,443974,855048,108547,111354,219901
3301801,6449,6788,13237,1554,1584,3138
3301850,25280,26203,51483,6751.809,6911.512,13663.32
3301876,11046,11805,22851,2550,2527,5077
3301900,106190,111818,218008,26563.1,27512.06,54075.16
3302007,54409,54682,109091,14218,14046,28264
3302056,6853,7210,14063,1570,1584,3154
3302106,11192,11707,22899,2628,2523,5151
3302205,46553,49288,95841,11588,11713,23301
3302254,14213,14570,28783,3625,3627,7252
3302270,48080,47412,95492,14205,12718,26923
3302304,3751,3736,7487,905,872,1777
3302403,102432,104296,206728,29420,29720,59140
3302452,2528,2741,5269,612,664,1276
3302502,110576,116746,227322,28974,29142,58116
3302601,17962,18494,36456,4312,4504,8816
3302700,62649,64812,127461,14238.02,14824.53,29062.55
3302809,8651,9284,17935,2002,2001,4003
3302858,79790,88586,168376,20447,21112,41559
3302908,11719,12923,24642,2687,2745,5432
3303005,13026,13817,26843,3244,3200,6444
3303104,7445,7637,15082,1766,1699,3465
3303203,73674,83751,157425,18600,19169,37769
3303302,225838,261724,487562,55940,58038,113978
3303401,87254,94828,182082,21137,21197,42334
3303500,381750,414507,796257,99871,102759,202630
3303609,23793,23331,47124,6188,5916,12104
3303708,19751,21333,41084,4822,4817,9639
3303807,18964,18569,37533,4673,4711,9384
3303856,12817,13542,26359,3286,3315,6601
3303906,140996,154921,295917,34943,34952,69895
3303955,11034,11685,22719,2899,2953,5852
3304003,12917,13397,26314,3091,3150,6241
3304102,8874,8886,17760,2211,2108,4319
3304110,8242,8350,16592,2238,2231,4469
3304128,6238,6555,12793,1640,1610,3250
3304144,66585,71377,137962,17925,18300,36225
3304151,10043,10199,20242,2599,2625,5224
3304201,58268,61501,119769,15326,15329,30655
3304300,27318,28233,55551,6861,6991,13852
3304409,8769,8656,17425,2046,2012,4058
3304508,4211,4350,8561,1035,1064,2099
3304524,52207,53469,105676,13466,13694,27160
3304557,2959817,3360629,6320446,756263.4,768069.1,1524333
3304607,5275,5046,10321,1160,1159,2319
3304706,19961,20628,40589,4806,4702,9508
3304755,20808,20546,41354,5335,5080,10415
3304805,18394,19149,37543,4371,4382,8753
3304904,475264,524464,999728,118682,125944,244626
3305000,16229,16518,32747,4184,4066,8250
3305109,218104,240569,458673,56274,58194,114468
3305133,3498,3505,7003,831,856,1687
3305158,10145,10106,20251,2537,2583,5120
3305208,43431,44444,87875,10692,10839,21531
3305307,4467,4428,8895,1042,1002,2044
3305406,8766,8759,17525,2101,2011,4112
3305505,36855,37379,74234,9451,9118,18569
3305554,38433,39753,78186,10531,10573,21104
3305604,10808,10541,21349,2718,2704,5422
3305703,7652,7248,14900,1977,1940,3917
3305752,15289,15443,30732,3905,3861,7766
3305802,78275,85471,163746,19485,20329,39814
3305901,5258,5031,10289,1237,1175,2412
3306008,37014,40418,77432,9288,9647,18935
3306107,34450,37393,71843,8399,8494,16893
3306156,4756,4719,9475,1245,1218,2463
3306206,16391,18019,34410,4279,4412,8691
3306305,122919,134884,257803,31602,32281,63883
3500105,16374,17423,33797,3979,3946,7925
3500204,1787,1770,3557,398,418,816
3500303,16217,15931,32148,4544,4180,8724
3500402,3747,3837,7584,880,841,1721
3500501,8457,8809,17266,2066,2079,4145
3500550,2779,2822,5601,639,638,1277
3500600,1262,1445,2707,262,262,524
3500709,17076,17448,34524,4609,4549,9158
3500758,2456,2428,4884,660,631,1291
3500808,1981,1910,3891,446,404,850
3500907,2051,1764,3815,582,485,1067
3501004,7808,7799,15607,1978,1938,3916
3501103,2109,1993,4102,508,442,950
3501152,8500,8339,16839,2282,2222,4504
3501202,1999,1898,3897,392,380,772
3501301,11640,11873,23513,2999,2824,5823
3501400,2959,1691,4650,1139,393,1532
3501509,1482,1518,3000,371,359,730
3501608,103174,107464,210638,26999,26056,53055
3501707,17333,17145,34478,4990,4873,9863
3501806,2862,2844,5706,629,627,1256
3501905,32442,33387,65829,8549,8216,16765
3502002,2203,2090,4293,592,505,1097
3502101,27190,28144,55334,6823,6281,13104
3502200,11245,10965,22210,2820,2752,5572
3502309,2909,2744,5653,674,664,1338
3502408,1863,1875,3738,486,434,920
3502507,16898,18109,35007,4614,4626,9240
3502606,2177,2273,4450,462,434,896
3502705,12577,12614,25191,3167,3174,6341
3502754,8697,8383,17080,2395,2365,4760
3502804,87329,94250,181579,21490,21835,43325
3502903,13607,13692,27299,3326,3224,6550
3503000,2589,2563,5152,670,648,1318
3503109,3088,3035,6123,804,762,1566
3503158,1255,1238,2493,291,301,592
3503208,100655,108007,208662,26697,26530,53227
3503307,58688,60155,118843,15774,15481,31255
3503356,971,954,1925,221,232,453
3503406,3997,3844,7841,865,852,1717
3503505,1831,1865,3696,461,434,895
3503604,5453,5126,10579,1582,1439,3021
3503703,4366,4181,8547,1162,1044,2206
3503802,22075,22102,44177,6211,5952,12163
3503901,36939,37966,74905,10060,9926,19986
3503950,907,902,1809,207,197,404
3504008,46317,48827,95144,12224,11651,23875
3504107,62211,64392,126603,16132,15619,31751
3504206,7102,7100,14202,1821,1713,3534
3504305,2506,2453,4959,639,632,1271
3504404,6249,5061,11310,2190,1336,3526
3504503,41136,41798,82934,11105,10273,21378
3504602,7249,7354,14603,1776,1734,3510
3504701,3002,700,3702,1344,181,1525
3504800,3998,4162,8160,965,902,1867
3504909,5051,5172,10223,1239,1178,2417
3505005,1591,1525,3116,346,330,676
3505104,3323,3270,6593,855,749,1604
3505203,15816,15777,31593,4009,3629,7638
3505302,17252,17994,35246,4328,4199,8527
3505351,2770,2474,5244,684,610,1294
3505401,4050,3679,7729,875,868,1743
3505500,54169,57932,112101,14496,14238,28734
3505609,14321,14175,28496,4331,4194,8525
3505708,117051,123698,240749,33763,34534,68297
3505807,10032,10413,20445,2545,2488,5033
3505906,27744,28732,56476,7256,7166,14422
3506003,166649,177288,343937,44610,43145,87755
3506102,36529,38506,75035,9410,9417,18827
3506201,1364,1310,2674,367,311,678
3506300,5250,5525,10775,1310,1211,2521
3506359,23829,23816,47645,6222,6432,12654
3506409,3491,3557,7048,880,819,1699
3506508,53075,55653,108728,13477,13552,27029
3506607,14413,14162,28575,3787,3662,7449
3506706,6875,6770,13645,1845,1785,3630
3506805,5409,5450,10859,1459,1352,2811
3506904,4906,4712,9618,1145,1067,2212
3507001,24313,24001,48314,6888,6523,13411
3507100,9922,9786,19708,2656,2572,5228
3507159,1816,1755,3571,479,481,960
3507209,422,383,805,112.2525,90.04599,202.2985
3507308,2178,2090,4268,614,523,1137
3507407,7350,7179,14529,1844,1723,3567
3507456,1143,1150,2293,296,289,585
3507506,61761,65567,127328,16147.65,16249.9,32397.56
3507605,72081,74663,146744,18901,18573,37474
3507704,2552,2469,5021,687,590,1277
3507753,1330,1243,2573,328,298,626
3507803,10465,10642,21107,2772,2647,5419
3507902,10711,10869,21580,2827,2688,5515
3508009,9501,9062,18563,2407,2304,4711
3508108,7732,7686,15418,1910,1812,3722
3508207,2073,1980,4053,528,486,1014
3508306,2220,2145,4365,585,547,1132
3508405,21080,20524,41604,6005,5754,11759
3508504,41996,42756,84752,11058,10806,21864
3508603,14749,15342,30091,3935,3643,7578
3508702,9285,9253,18538,2201,2161,4362
3508801,8174,8433,16607,2035,2041,4076
3508900,2091,1981,4072,533,474,1007
3509007,42298,44231,86529,11387,11721,23108
3509106,2652,2387,5039,662,512,1174
3509205,31997,32117,64114,9281,9282,18563
3509254,14328,14044,28372,3548,3616,7164
3509304,5025,4743,9768,1451,1192,2643
3509403,11699,11672,23371,3122,3034,6156
3509452,2853,2714,5567,706,682,1388
3509502,520865,559248,1080113,140747,141822,282569
3509601,36392,37682,74074,10010,10010,20020
3509700,23393,24396,47789,6280.645,6200.063,12480.71
3509809,2339,2200,4539,556,503,1059
3509908,6134,6092,12226,1452,1436,2888
3509957,2223,2162,4385,611,571,1182
3510005,14658,15226,29884,3753,3654,7407
3510104,1315,1353,2668,304,324,628
3510153,2216,2153,4369,560,562,1122
3510203,23021,23157,46178,5809,5895,11704
3510302,9038,8494,17532,2512,2139,4651
3510401,24353,24223,48576,6724,6322,13046
3510500,49959,50881,100840,12956.51,12622.16,25578.67
3510609,179284,190300,369584,50742,51790,102532
3510708,5830,5975,11805,1402,1316,2718
3510807,14997,13310,28307,4160,3203,7363
3510906,1347,1287,2634,314,315,629
3511003,8975,9028,18003,2183,2158,4341
3511102,54776,58044,112820,14053,13753,27806
3511201,3632,3495,7127,968,868,1836
3511300,3977,3995,7972,898,904,1802
3511409,8673,8859,17532,2245,2189,4434
3511508,19635,19982,39617,5303,5094,10397
3511607,8063,7477,15540,2256,1965,4221
3511706,7686,7399,15085,2172,2006,4178
3511904,3661,3404,7065,1207,974,2181
3512001,8626,8745,17371,2308,2254,4562
3512100,3066,2928,5994,846,787,1633
3512209,12757,12472,25229,3785,3495,7280
3512308,8191,8097,16288,1927,1906,3833
3512407,10600,10480,21080,2855,2749,5604
3512506,2610,2628,5238,662,648,1310
3512605,2565,2436,5001,586,559,1145
3512704,1974,1900,3874,522,451,973
3512803,29410,29417,58827,8088,8016,16104
3512902,3652,3562,7214,869,740,1609
3513009,98455,102695,201150,26415,26753,53168
3513108,15889,15802,31691,4423,4047,8470
3513207,3874,3714,7588,1027,997,2024
3513306,1110,1164,2274,268,250,518
3513405,37505,39534,77039,9816,9584,19400
3513504,59229,59491,118720,16651,16192,32843
3513603,11164,10702,21866,2739,2554,5293
3513702,15329,15727,31056,4051,3941,7992
3513801,186803,199286,386089,53599,54423,108022
3513850,875,814,1689,180.8896,199.1104,380
3513900,5587,5621,11208,1386,1375,2761
3514007,4116,3823,7939,1299,1095,2394
3514106,12417,12344,24761,3361,3140,6501
3514205,1091,1005,2096,233,197,430
3514304,4364,4245,8609,1120,1010,2130
3514403,21405,21853,43258,5435,4792,10227
3514502,5970,6281,12251,1466,1447,2913
3514601,4096,4047,8143,1207,1148,2355
3514700,3115,3203,6318,795,749,1544
3514809,7478,7163,14641,1810,1745,3555
3514908,8168,7607,15775,2347,1997,4344
3514924,1650,1470,3120,452,365,817
3514957,1259,1164,2423,323,289,612
3515004,116728,123502,240230,33258,34313,67571
3515103,31186,31583,62769,8225,8237,16462
3515129,1517,1503,3020,360,345,705
3515152,8233,7488,15721,2670,2326,4996
3515186,20507,21400,41907,5166,5092,10258
3515194,2145,2099,4244,592,575,1167
3515202,4133,4075,8208,1005,950,1955
3515301,1370,1288,2658,378,313,691
3515350,4832,4753,9585,1199,1189,2388
3515400,7426,7894,15320,1875,1865,3740
3515509,31518,33178,64696,7779,7577,15356
3515608,2726,2808,5534,608,647,1255
3515657,794,769,1563,185,179,364
3515707,82143,86163,168306,23657,23784,47441
3515806,880,872,1752,195,189,384
3515905,1496,1507,3003,351,298,649
3516002,7055,5793,12848,2127,1385,3512
3516101,1383,1446,2829,329,325,654
3516200,155464,163176,318640,41714,41328,83042
3516309,76636,77836,154472,22259.16,22114.07,44373.22
3516408,67462,64142,131604,20728,17825,38553
3516507,1375,1333,2708,326,282,608
3516606,3506,3505,7011,848,807,1655
3516705,20970,22145,43115,5270,5252,10522
3516804,2298,1895,4193,842,475,1317
3516853,2284,2135,4419,642,614,1256
3516903,5352,5317,10669,1303,1271,2574
3517000,5861,4904,10765,1754,1129,2883
3517109,2289,2276,4565,548,531,1079
3517208,5367,5303,10670,1405,1401,2806
3517307,2697,2728,5425,730,654,1384
3517406,18520,18884,37404,4702,4709,9411
3517505,9029,8840,17869,2409,2174,4583
3517604,9153,8845,17998,2165,2176,4341
3517703,9884,9974,19858,2645,2522,5167
3517802,4195,4240,8435,937,923,1860
3517901,5084,4892,9976,1406,1321,2727
3518008,963,1007,1970,227,218,445
3518107,3218,3186,6404,855,826,1681
3518206,15091,15506,30597,3773,3726,7499
3518305,12998,12846,25844,3365,3338,6703
3518404,53946,58126,112072,13917,14174,28091
3518503,8927,5638,14565,3041,1400,4441
3518602,17912,17574,35486,5363,4991,10354
3518701,141711,149041,290752,38019,38529,76548
3518800,595043,626936,1221979,164210,165254,329464
3518859,3579,3387,6966,958,857,1815
3518909,2436,2318,4754,611,584,1195
3519006,4351,4345,8696,1116,1045,2161
3519055,5725,5574,11299,1511,1430,2941
3519071,97439,95253,192692,28895,26198,55093
3519105,5164,4849,10013,1386,1158,2544
3519204,3249,3170,6419,795,732,1527
3519253,4196,2180,6376,1143,578,1721
3519303,15814,14920,30734,4712,4213,8925
3519402,5414,5482,10896,1500,1340,2840
3519501,3395,3330,6725,835,796,1631
3519600,26212,26946,53158,7199,6911,14110
3519709,36216,35001,71217,9323,9074,18397
3519808,3795,3667,7462,1094,971,2065
3519907,3779,3849,7628,911,904,1815
3520004,11653,11709,23362,3194.048,3083.372,6277.42
3520103,13842,14110,27952,3897,3548,7445
3520202,4522,4309,8831,1081,1063,2144
3520301,14462,14379,28841,3134,3087,6221
3520400,14329,13867,28196,4159.028,3902.699,8061.728
3520426,4475,4550,9025,836,908,1744
3520442,12199,12865,25064,2926,2956,5882
3520509,100178,101441,201619,27746,26617,54363
3520608,2423,2402,4825,640,572,1212
3520707,1920,1983,3903,451,432,883
3520806,1821,1809,3630,452,426,878
3520905,6893,6770,13663,1819.343,1572.596,3391.939
3521002,15209,13091,28300,4670,3544,8214
3521101,3110,2906,6016,893,758,1651
3521150,2267,2196,4463,528,522,1050
3521200,2171,2128,4299,562,530,1092
3521309,7210,6938,14148,2115,1835,3950
3521408,10046,9983,20029,2839,2684,5523
3521507,3803,3472,7275,1141,836,1977
3521606,4532,3257,7789,1571,684,2255
3521705,9016,8842,17858,2223,2207,4430
3521804,12761,11247,24008,3179,2903,6082
3521903,7349,7207,14556,1782,1640,3422
3522000,1705,1541,3246,465,398,863
3522109,42192,44865,87057,9594,10029,19623
3522158,1687,1541,3228,341,325,666
3522208,76270,76344,152614,22242,20901,43143
3522307,72167,72210,144377,20176,18486,38662
3522406,43243,44510,87753,11458,11524,22982
3522505,98746,102023,200769,28415,28694,57109
3522604,33950,34587,68537,8798,8469,17267
3522653,2002,1878,3880,494,484,978
3522703,19867,20184,40051,5200,4885,10085
3522802,7280,7269,14549,1769,1652,3421
3522901,6150,6023,12173,1647,1550,3197
3523008,2257,2100,4357,588,499,1087
3523107,158542,163228,321770,45011,45872,90883
3523206,23523,24411,47934,6181,6184,12365
3523305,7794,7677,15471,1936,1965,3901
3523404,50147,51324,101471,13545,13377,26922
3523503,9230,8822,18052,2578,2448,5026
3523602,9154,6370,15524,3423,1686,5109
3523701,3013,2901,5914,765,720,1485
3523800,3908,3638,7546,1083,941,2024
3523909,76219,77928,154147,20686,20201,40887
3524006,22793,22066,44859,6490,6142,12632
3524105,18874,19821,38695,4943,4731,9674
3524204,3338,3254,6592,967,847,1814
3524303,34794,36868,71662,9246,9102,18348
3524402,103092,108122,211214,26404,26490,52894
3524501,2892,2765,5657,795,727,1522
3524600,8777,8431,17208,2139,2064,4203
3524709,22004,22307,44311,6111,5940,12051
3524808,22986,24026,47012,5532,5437,10969
3524907,2769,2580,5349,739,641,1380
3525003,53063,55281,108344,15308,15943,31251
3525102,18949,18712,37661,5033,4791,9824
3525201,12005,11842,23847,3220,3090,6310
3525300,64214,66826,131040,16595,16521,33116
3525409,1622,1538,3160,424,398,822
3525508,5927,5841,11768,1528,1461,2989
3525607,2098,2052,4150,543,563,1106
3525706,16351,16412,32763,4454,4207,8661
3525805,2179,2251,4430,562,563,1125
3525854,1444,1354,2798,427,373,800
3525904,180049,190077,370126,46211,45831,92042
3526001,9921,8805,18726,2635,1962,4597
3526100,9740,9506,19246,2209,2241,4450
3526209,14543,14194,28737,3652,3560,7212
3526308,2479,2362,4841,573,517,1090
3526407,12465,12786,25251,3221,3125,6346
3526506,6183,2596,8779,2464,608,3072
3526605,3320,3270,6590,905,876,1781
3526704,46030,45726,91756,13153,12352,25505
3526803,30498,30930,61428,8299,7994,16293
3526902,135628,140394,276022,35689,35595,71284
3527009,3326,3386,6712,808,832,1640
3527108,34681,36751,71432,9262,8614,17876
3527207,39858,42679,82537,10675,10567,21242
3527256,1107,1021,2128,277,227,504
3527306,18801,18324,37125,6082,5707,11789
3527405,10559,9323,19882,2793,2188,4981
3527504,1118,1131,2249,266,256,522
3527603,5832,5454,11286,1709,1607,3316
3527702,2612,2418,5030,789,633,1422
3527801,2121,2232,4353,543,547,1090
3527900,1354,1360,2714,346,341,687
3528007,8152,8107,16259,2148,2111,4259
3528106,3880,3783,7663,911,864,1775
3528205,1837,1827,3664,411,400,811
3528304,1651,1549,3200,370,337,707
3528403,21538,21685,43223,5558,5587,11145
3528502,40975,39981,80956,10316.76,9808.255,20125.02
3528601,4519,4473,8992,1136,1067,2203
3528700,3048,1764,4812,1286,397,1683
3528809,6663,6669,13332,1755,1669,3424
3528858,1349,1284,2633,334,312,646
3528908,2021,1895,3916,555,475,1030
3529005,104726,112019,216745,27317,27030,54347
3529104,1063,1050,2113,234,238,472
3529203,12601,11618,24219,3484,2762,6246
3529302,38033,38753,76786,10147,10109,20256
3529401,204093,212971,417064,58096,58835,116931
3529500,2357,2283,4640,624,544,1168
3529609,1892,1963,3855,435,453,888
3529658,957,929,1886,200,205,405
3529708,10204,10247,20451,2792,2573,5365
3529807,5992,6046,12038,1558,1540,3098
3529906,10412,10180,20592,2463,2464,4927
3530003,1401,1419,2820,312,277,589
3530102,15055,12428,27483,3934,2698,6632
3530201,8663,8396,17059,2006,1928,3934
3530300,26402,27390,53792,6608,6471,13079
3530409,2193,2102,4295,488,512,1000
3530508,33059,33231,66290,8659,8049,16708
3530607,188857,198922,387779,49688,50277,99965
3530706,68094,69151,137245,18043,17860,35903
3530805,42597,43908,86505,10981,10754,21735
3530904,1663,1603,3266,460,400,860
3531001,1101,1031,2132,249,203,452
3531100,23098,23195,46293,5726.789,4874.049,10600.84
3531209,3581,3571,7152,877,801,1678
3531308,22978,23664,46642,5855,5711,11566
3531407,10814,10932,21746,2764,2609,5373
3531506,9491,9440,18931,2519,2384,4903
3531605,2011,2052,4063,457,442,899
3531704,2150,1970,4120,491,421,912
3531803,24472,24477,48949,6695,6624,13319
3531902,14879,14237,29116,4375,4070,8445
3532009,5895,5874,11769,1587,1506,3093
3532058,2162,2128,4290,573,578,1151
3532108,2097,2089,4186,433,398,831
3532157,1357,1350,2707,355,335,690
3532207,2170,2118,4288,557,572,1129
3532306,3486,3192,6678,737,690,1427
3532405,8454,7960,16414,2150,1958,4108
3532504,4363,4409,8772,1018,998,2016
3532603,5281,5444,10725,1228,1197,2425
3532702,2262,2012,4274,650,543,1193
3532801,2922,2969,5891,701,684,1385
3532827,4345,4170,8515,1197,1145,2342
3532843,1076,1038,2114,193,188,381
3532868,556,569,1125,122.7315,136.2685,259
3532900,4649,4651,9300,1258,1239,2497
3533007,9659,9521,19180,2622,2344,4966
3533106,1102,1075,2177,241,215,456
3533205,1525,1543,3068,420,391,811
3533254,2479,2113,4592,799,643,1442
3533304,1820,1621,3441,516,400,916
3533403,25345,25897,51242,6918.036,6582.226,13500.26
3533502,18271,18322,36593,4670,4338,9008
3533601,3410,3407,6817,907,834,1741
3533700,2137,2026,4163,524,494,1018
3533809,1344,1329,2673,298,265,563
3533908,24685,25339,50024,6501,6287,12788
3534005,1993,1891,3884,498,482,980
3534104,2985,3112,6097,787,723,1510
3534203,2899,2776,5675,821,807,1628
3534302,19495,20286,39781,5269,5277,10546
3534401,320436,346304,666740,88171,90006,178177
3534500,1217,1320,2537,269,280,549
3534609,15554,15363,30917,4335,3361,7696
3534708,49981,53054,103035,12845,12704,25549
3534757,4190,4215,8405,1099,1086,2185
3534807,3866,3934,7800,989,985,1974
3534906,7744,5482,13226,2525,1162,3687
3535002,5595,5456,11051,1489,1306,2795
3535101,5861,5073,10934,2041,1545,3586
3535200,4805,4779,9584,984,974,1958
3535309,10353,10833,21186,2371,2391,4762
3535408,7312,7271,14583,1905,1858,3763
3535507,21259,21019,42278,5687,5158,10845
3535606,8837,8551,17388,2229,2147,4376
3535705,3012,2886,5898,787,710,1497
3535804,9062,8746,17808,2320,2284,4604
3535903,1950,1865,3815,442,412,854
3536000,5535,5309,10844,1334,1156,2490
3536109,2844,2738,5582,689,673,1362
3536208,9138,9308,18446,2227,2403,4630
3536257,1044,988,2032,249,232,481
3536307,6596,6404,13000,1745,1628,3373
3536406,3290,3049,6339,865,795,1660
3536505,40668,41478,82146,10940.67,10715.32,21655.98
3536570,919,860,1779,229,195,424
3536604,4299,4290,8589,1119,1067,2186
3536703,20861,20636,41497,5499,5327,10826
3536802,3030,2750,5780,739,652,1391
3536901,1314,1244,2558,272,258,530
3537008,7985,7715,15700,2187,2043,4230
3537107,20605,20953,41558,5419.849,5414.584,10834.43
3537156,1463,1477,2940,357,328,685
3537206,5156,5048,10204,1091,1199,2290
3537305,28568,29942,58510,7180,6896,14076
3537404,12270,12692,24962,3024,2914,5938
3537503,3786,3668,7454,996,926,1922
3537602,29140,30633,59773,6544.423,6689.636,13234.06
3537701,2662,2625,5287,668,667,1335
3537800,26578,25565,52143,6711,6390,13101
3537909,13415,12991,26406,3463,3426,6889
3538006,72288,74707,146995,19356,19472,38828
3538105,7692,7347,15039,2024,1743,3767
3538204,6593,6512,13105,1601,1505,3106
3538303,1753,1784,3537,404,435,839
3538501,6817,7290,14107,1725,1668,3393
3538600,12514,12602,25116,3138,3022,6160
3538709,178345,186226,364571,47871,46875,94746
3538808,13826,14649,28475,3410,3357,6767
3538907,12570,10134,22704,4289,2383,6672
3539004,5393,5230,10623,1358,1247,2605
3539103,7818,7915,15733,2078,2125,4203
3539202,12082,12612,24694,3094,3066,6160
3539301,34297,35784,70081,8823,8588,17411
3539400,5986,6086,12072,1486,1392,2878
3539509,18009,17298,35307,5119,4926,10045
3539608,2313,2150,4463,607,551,1158
3539707,1660,1532,3192,393,346,739
3539806,51292,54721,106013,14198,14373,28571
3539905,2671,2724,5395,732,648,1380
3540002,9793,10171,19964,2426,2458,4884
3540101,1793,1688,3481,423,382,805
3540200,21175,19069,40244,6548,5764,12312
3540259,2160,1914,4074,607,514,1121
3540309,1256,1262,2518,324,278,602
3540408,2139,2084,4223,482,482,964
3540507,4276,4050,8326,948,906,1854
3540606,24535,24358,48893,6545,6251,12796
3540705,25502,25898,51400,6705,6526,13231
3540754,10974,8423,19397,4027,2280,6307
3540804,7852,7597,15449,2142,1835,3977
3540853,2080,778,2858,1059,194,1253
3540903,8882,8495,17377,2745,2345,5090
3541000,125926,136125,262051,31514.04,32114.18,63628.23
3541059,2379,2220,4599,684,576,1260
3541109,2038,2085,4123,524,494,1018
3541208,6683,6887,13570,1627,1548,3175
3541307,20217,21101,41318,5178,5172,10350
3541406,99894,107716,207610,25403,25557,50960
3541505,18911,18999,37910,4604,4275,8879
3541604,17756,17918,35674,4610,4412,9022
3541653,1707,1529,3236,369,369,738
3541703,6393,6406,12799,1675,1586,3261
3541802,1424,1384,2808,376,341,717
3541901,5757,5552,11309,1548,1463,3011
3542008,2969,3035,6004,754,758,1512
3542107,4257,4355,8612,1116,1142,2258
3542206,14153,14651,28804,3579,3462,7041
3542305,2017,1856,3873,426,432,858
3542404,9188,9306,18494,2289,2199,4488
3542503,4681,2642,7323,2383,634,3017
3542602,26656,27605,54261,6445,6805,13250
3542701,3296,3291,6587,865,907,1772
3542800,1743,1615,3358,384,351,735
3542909,6104,6031,12135,1628,1582,3210
3543006,9396,8873,18269,2412,2373,4785
3543105,2218,2055,4273,578,551,1129
3543204,2231,2215,4446,482,509,991
3543238,1089,1098,2187,233,219,452
3543253,3795,3627,7422,945,930,1875
3543303,55318,57750,113068,14636,14606,29242
3543402,290171,314511,604682,80820.26,81540.3,162360.6
3543501,3047,3116,6163,713,671,1384
3543600,1724,1712,3436,407,377,784
3543709,5244,5170,10414,1359,1345,2704
3543808,5051,4884,9935,1290,1123,2413
3543907,90687,95566,186253,23990,23573,47563
3544004,14914,14587,29501,4335,3957,8292
3544103,21804,22170,43974,6057,6081,12138
3544202,6022,4553,10575,1883,1191,3074
3544251,9780,9911,19691,2490,2477,4967
3544301,4842,4757,9599,1320,1229,2549
3544400,1392,1337,2729,364,345,709
3544509,1415,1447,2862,282,293,575
3544608,2623,2594,5217,645,599,1244
3544707,1191,1204,2395,283,268,551
3544806,2789,2662,5451,648,624,1272
3544905,5241,5327,10568,1346,1345,2691
3545001,7906,7729,15635,1918,1901,3819
3545100,2477,2341,4818,621,556,1177
3545159,3519,3540,7059,896,888,1784
3545209,52132,53384,105516,14409.41,13817.29,28226.7
3545308,19949,20183,40132,5243,5150,10393
3545407,4353,4434,8787,1006,1010,2016
3545506,1885,1814,3699,470,458,928
3545605,7164,7169,14333,1855,1746,3601
3545704,2905,2818,5723,720,618,1338
3545803,89222,90787,180009,24576,23896,48472
3546009,6875,6888,13763,1687,1631,3318
3546108,1073,1011,2084,270,213,483
3546207,1980,2022,4002,479,480,959
3546256,966,987,1953,245,243,488
3546306,15222,14710,29932,4378,4029,8407
3546405,21512,22409,43921,5389,5332,10721
3546504,2852,2716,5568,856,792,1648
3546603,14084,15155,29239,3439,3559,6998
3546702,10954,10680,21634,3226.058,2966.627,6192.686
3546801,25248,25205,50453,6720,6392,13112
3546900,4130,4118,8248,1195,1095,2290
3547007,2746,2667,5413,822,732,1554
3547106,1423,1408,2831,340,334,674
3547205,841,800,1641,162.907,155.093,318
3547304,53671,55142,108813,14444,14655,29099
3547403,1264,1279,2543,265,278,543
3547502,12813,13665,26478,2968,2973,5941
3547601,11781,12081,23862,3101,2989,6090
3547650,743,704,1447,169,140,309
3547700,9982,10493,20475,2430,2366,4796
3547809,324458,351949,676407,84069,83664,167733
3547908,3260,3044,6304,833,749,1582
3548005,10412,10238,20650,2804,2684,5488
3548054,3879,3747,7626,1009,906,1915
3548104,3045,2898,5943,741,661,1402
3548203,3269,3217,6486,799,788,1587
3548302,1403,1400,2803,335,291,626
3548401,2167,2110,4277,641,569,1210
3548500,191912,227488,419400,44885,46636,91521
3548609,5271,5197,10468,1182,1154,2336
3548708,369626,395837,765463,99851,100639,200490
3548807,68853,80410,149263,16172,16569,32741
3548906,108914,113036,221950,29002.28,27795.03,56797.3
3549003,1400,1393,2793,311,272,583
3549102,40546,43093,83639,10076,9902,19978
3549201,1290,1276,2566,291,283,574
3549250,898,882,1780,224,206,430
3549300,1057,1046,2103,223,202,425
3549409,22792,23720,46512,6137,6074,12211
3549508,4312,4094,8406,1223,1023,2246
3549607,2047,2030,4077,476,463,939
3549706,25547,26353,51900,6771,6592,13363
3549805,196016,212242,408258,50712,51173,101885
3549904,308624,321297,629921,84452,84203,168655
3549953,7087,6886,13973,1849,1820,3669
3550001,5318,5079,10397,1247,1242,2489
3550100,18766,19576,38342,4875,4774,9649
3550209,15995,15455,31450,4137,3951,8088
3550308,5328632,5924871,1.13e+07,1429004,1478458,2907462
3550407,15423,16239,31662,3762,3703,7465
3550506,3670,3528,7198,893,871,1764
3550605,38762,40059,78821,9732,9768,19500
3550704,36886,37056,73942,9780.666,9896.302,19676.97
3550803,6166,5933,12099,1569,1469,3038
3550902,7061,7285,14346,1787,1799,3586
3551009,159664,172781,332445,42804,42954,85758
3551108,4594,4433,9027,1145,1067,2212
3551207,1819,1803,3622,466,417,883
3551306,1525,1506,3031,386,366,752
3551405,6873,4383,11256,2197,1128,3325
3551504,19486,19392,38878,5770,5558,11328
3551603,12866,13521,26387,2975,3018,5993
3551702,54701,55373,110074,15339,15132,30471
3551801,6681,6324,13005,1591,1486,3077
3551900,8045,7456,15501,2313,2070,4383
3552007,2936,2856,5792,734,700,1434
3552106,18205,18481,36686,4285,4238,8523
3552205,287014,299611,586625,79160.94,77140.77,156301.7
3552304,3742,3693,7435,953,918,1871
3552403,119863,121448,241311,33886,33531,67417
3552502,128694,133786,262480,34893,35164,70057
3552551,1748,1635,3383,435,383,818
3552601,5745,5618,11363,1490,1362,2852
3552700,7565,7121,14686,2197,1840,4037
3552809,116895,127633,244528,32873,34123,66996
3552908,2861,2853,5714,736,661,1397
3553005,5385,5443,10828,1659,1552,3211
3553104,2972,2922,5894,812,706,1518
3553203,2696,2751,5447,685,674,1359
3553302,11173,11233,22406,2812,2861,5673
3553401,12042,12013,24055,3040,2813,5853
3553500,4043,3969,8012,956.4477,960.4162,1916.864
3553609,6331,6406,12737,1641,1587,3228
3553658,1373,1353,2726,354,317,671
3553708,26662,27326,53988,6944,6574,13518
3553807,11092,11199,22291,2839,2819,5658
3553856,2578,2573,5151,753,713,1466
3553906,3293,3314,6607,901,847,1748
3553955,6583,6302,12885,1791,1688,3479
3554003,53034,54292,107326,14183,13923,28106
3554102,136752,141934,278686,36737,35824,72561
3554201,2467,2342,4809,622,556,1178
3554300,10665,10721,21386,2732,2802,5534
3554409,4306,4199,8505,1139,1100,2239
3554508,18249,18586,36835,4961,4690,9651
3554607,1364,1282,2646,296,267,563
3554656,1188,1066,2254,251,217,468
3554706,4707,4623,9330,1224,1138,2362
3554755,770,774,1544,195,199,394
3554805,21663,19321,40984,6450,4884,11334
3554904,2718,2709,5427,608,593,1201
3554953,3022,2908,5930,706,655,1361
3555000,30734,32742,63476,7467,7224,14691
3555109,7580,6689,14269,1878,1437,3315
3555208,997,933,1930,212,196,408
3555307,982,996,1978,192.0185,205.9815,398
3555356,2715,2574,5289,731,649,1380
3555406,39176,39625,78801,9623.103,10156.32,19779.42
3555505,2284,2143,4427,567,546,1113
3555604,4707,4764,9471,1174,1124,2298
3555703,829,770,1599,211,184,395
3555802,4395,4441,8836,1042,990,2032
3555901,641,610,1251,146.0916,148.9084,295
3556008,6321,6393,12714,1564,1471,3035
3556107,5548,5488,11036,1507,1424,2931
3556206,52676,54117,106793,13300,13030,26330
3556305,12413,10163,22576,3734,2705,6439
3556354,4519,4282,8801,1124,1048,2172
3556404,19488,19778,39266,4928,4892,9820
3556453,21342,21655,42997,5739,5612,11351
3556503,53415,53674,107089,15333,15180,30513
3556602,5298,5471,10769,1304,1246,2550
3556701,31483,32128,63611,8295,8209,16504
3556800,8714,8583,17297,2419,2318,4737
3556909,3544,3342,6886,1115,942,2057
3556958,891,846,1737,219,220,439
3557006,54013,54796,108809,14951,14740,29691
3557105,41315,43377,84692,10526,10458,20984
3557154,1173,1162,2335,282,274,556
3557204,6028,6086,12114,1514,1452,2966
3557303,5074,4970,10044,1391,1320,2711
4100103,3916,3848,7764,949,930,1879
4100202,3298,3078,6376,762,712,1474
4100301,4306,3964,8270,1083,957,2040
4100400,51136,52068,103204,14053,14323,28376
4100459,2202,2104,4306,516,520,1036
4100509,10157,10359,20516,2475,2420,4895
4100608,6842,6821,13663,1742,1657,3399
4100707,5129,5050,10179,1338,1261,2599
4100806,5205,5078,10283,1325,1251,2576
4100905,2757,2686,5443,748,727,1475
4101002,8586,8722,17308,2256,2275,4531
4101051,1439,1435,2874,340,304,644
4101101,10041,10569,20610,2421,2451,4872
4101150,1457,1402,2859,364,338,702
4101200,9349,9542,18891,2160,2152,4312
4101309,3857,3494,7351,840,800,1640
4101408,58682,62237,120919,15576,15543,31119
4101507,51039,53111,104150,13537,13390,26927
4101606,12949,12906,25855,3355,3433,6788
4101655,1764,1797,3561,406,402,808
4101705,6824,6595,13419,1679,1610,3289
4101804,59606,59517,119123,16994,16630,33624
4101853,1229,1224,2453,275,279,554
4101903,8012,8342,16354,1978,2002,3980
4102000,16178,16847,33025,3723,3764,7487
4102109,12142,12556,24698,3085,2921,6006
4102208,1970,1943,3913,454,421,875
4102307,5721,5579,11300,1544,1468,3012
4102406,15551,16633,32184,3920,4137,8057
4102505,6351,6305,12656,1506,1408,2914
4102604,4794,4941,9735,1234,1288,2522
4102703,1385,1342,2727,326,306,632
4102752,2018,1927,3945,437,391,828
4102802,7317,7762,15079,1817,1773,3590
4102901,8150,7730,15880,2085,1946,4031
4103008,2280,2288,4568,531,508,1039
4103024,1402,1362,2764,322,339,661
4103040,3346,3208,6554,892,825,1717
4103057,3994,3917,7911,850,854,1704
4103107,5552,5435,10987,1441,1351,2792
4103156,1969,1827,3796,431,390,821
4103206,3227,3334,6561,814,839,1653
4103222,1638,1655,3293,393,382,775
4103305,3933,3945,7878,931,802,1733
4103354,2939,2796,5735,672,677,1349
4103370,1603,1606,3209,387,359,746
4103404,1376,1319,2695,352,329,681
4103453,7345,7317,14662,2015,2015,4030
4103479,2170,2120,4290,492,464,956
4103503,4051,4018,8069,1035,973,2008
4103602,11648,12238,23886,2880,2899,5779
4103701,47299,49434,96733,12148,12210,24358
4103800,3679,3557,7236,961,863,1824
4103909,7647,7747,15394,1715,1778,3493
4103958,2136,1940,4076,496,457,953
4104006,19229,19540,38769,5398,5330,10728
4104055,2215,2192,4407,528,537,1065
4104105,3676,3449,7125,988,883,1871
4104204,55660,56717,112377,15023,14720,29743
4104253,12507,12336,24843,3463,3268,6731
4104303,42013,45181,87194,11272,11686,22958
4104402,8543,8112,16655,2046,1910,3956
4104428,7551,7432,14983,1881,1936,3817
4104451,6562,6390,12952,1616,1534,3150
4104501,9160,9366,18526,2189,2180,4369
4104600,7474,7496,14970,1869,1842,3711
4104659,9702,9461,19163,2708,2664,5372
4104709,6925,6781,13706,1683,1650,3333
4104808,139771,146434,286205,40544,40342,80886
4104907,33390,33694,67084,8681.981,8681.958,17363.94
4105003,5192,5010,10202,1322,1304,2626
4105102,5562,5628,11190,1446,1295,2741
4105201,8718,8220,16938,2130,2061,4191
4105300,5413,5619,11032,1305,1368,2673
4105409,9775,9904,19679,2492,2490,4982
4105508,34041,35917,69958,9187,9481,18668
4105607,5531,5531,11062,1473,1390,2863
4105706,8439,8801,17240,2098,2022,4120
4105805,105010,107957,212967,29358,29596,58954
4105904,11042,11303,22345,2751,2704,5455
4106001,4237,4042,8279,1021,968,1989
4106100,1839,1797,3636,453,442,895
4106209,8095,7796,15891,2065,1906,3971
4106308,7973,8339,16312,2080,2139,4219
4106407,22697,24231,46928,5795,5696,11491
4106456,3791,3447,7238,989,959,1948
4106506,10621,11128,21749,2697,2718,5415
4106555,2030,1972,4002,451,456,907
4106571,2133,2145,4278,551,531,1082
4106605,9988,10428,20416,2415,2376,4791
4106704,2310,2253,4563,582,570,1152
4106803,9322,8718,18040,2385,2107,4492
4106852,1635,1527,3162,376,350,726
4106902,835115,916792,1751907,229325.4,233633.7,462959.1
4107009,7107,6816,13923,1763,1770,3533
4107108,2730,2786,5516,634,630,1264
4107124,1796,1714,3510,419,406,825
4107157,2570,2457,5027,660,622,1282
4107207,17986,18193,36179,4938,4877,9815
4107256,3770,3675,7445,955,909,1864
4107306,2868,2960,5828,668,645,1313
4107405,3134,2969,6103,717,670,1387
4107504,6926,6980,13906,1744,1658,3402
4107520,981,989,1970,195,200,395
4107538,1959,1967,3926,491,456,947
4107546,2386,2291,4677,526,516,1042
4107553,1723,1749,3472,414,389,803
4107603,8025,8289,16314,2058,2040,4098
4107652,40574,41101,81675,11203,11319,22522
4107702,2398,2404,4802,587,560,1147
4107736,3039,2893,5932,784,738,1522
4107751,4103,4190,8293,950,974,1924
4107801,2502,2548,5050,609,575,1184
4107850,2398,2328,4726,539,557,1096
4107900,2953,2978,5931,774,769,1543
4108007,5687,5535,11222,1431,1425,2856
4108106,1289,1254,2543,299,280,579
4108205,3784,3757,7541,848,805,1653
4108304,124218,131870,256088,33448,35656,69104
4108320,3224,3194,6418,736,685,1421
4108403,38958,39985,78943,10922,10875,21797
4108452,2685,2735,5420,681,692,1373
4108502,6898,6771,13669,1761,1729,3490
4108551,1701,1636,3337,315,333,648
4108601,14006,15012,29018,3522,3590,7112
4108650,3924,3579,7503,975,927,1902
4108700,3385,3240,6625,897.8808,715.6668,1613.548
4108809,14932,15772,30704,3865.683,4014.884,7880.567
4108908,3106,3091,6197,811,793,1604
4108957,4008,3892,7900,1102,1008,2110
4109005,1934,1957,3891,498,481,979
4109104,1135,1084,2219,298,275,573
4109203,2574,2653,5227,678,612,1290
4109302,7263,7319,14582,1755,1728,3483
4109401,81797,85531,167328,22026,22022,44048
4109500,4176,3695,7871,1048,919,1967
4109609,15975,16120,32095,3825,3797,7622
4109658,3092,2863,5955,710,717,1427
4109708,14473,14278,28751,3658,3521,7179
4109757,3036,3030,6066,803,749,1552
4109807,23437,24761,48198,5896,6071,11967
4109906,4458,4381,8839,1061,959,2020
4110003,2004,1978,3982,534,503,1037
4110052,1136,1098,2234,273,247,520
4110078,5748,5526,11274,1406,1368,2774
4110102,14390,14065,28455,3869,3659,7528
4110201,5604,5339,10943,1404,1310,2714
4110300,1528,1460,2988,364,343,707
4110409,2187,2112,4299,512,444,956
4110508,7328,6822,14150,1929,1864,3793
4110607,7393,7588,14981,1800,1678,3478
4110656,1320,1258,2578,288,277,565
4110706,27708,28499,56207,7269,7090,14359
4110805,5433,5189,10622,1262,1165,2427
4110904,2296,2272,4568,621,534,1155
4110953,4549,4477,9026,1218,1175,2393
4111001,3390,3369,6759,780,775,1555
4111100,2946,3033,5979,752,750,1502
4111209,5262,5269,10531,1273,1266,2539
4111258,11984,11903,23887,3414,3437,6851
4111308,1822,1761,3583,445,424,869
4111407,6684,6131,12815,1732,1566,3298
4111506,15420,16396,31816,3693,3835,7528
4111555,3808,3706,7514,966,915,1881
4111605,1436,1574,3010,442,549,991
4111704,2488,2414,4902,540,541,1081
4111803,19136,19985,39121,5122,5008,10130
4111902,6109,6116,12225,1576,1551,3127
4112009,16092,16514,32606,4268,4395,8663
4112108,9880,10389,20269,2492,2355,4847
4112207,3273,3259,6532,749,754,1503
4112306,2539,2364,4903,597,533,1130
4112405,4324,4225,8549,1061,920,1981
4112504,6269,6055,12324,1435,1352,2787
4112603,699,710,1409,162.673,177.327,340
4112702,5873,6002,11875,1555,1492,3047
4112751,4469,4532,9001,953,918,1871
4112801,5321,5415,10736,1382,1340,2722
4112900,1738,1695,3433,369,359,728
4112959,3815,3826,7641,928,897,1825
4113007,3260,3350,6610,805,830,1635
4113106,2288,2218,4506,515,464,979
4113205,22646,22286,44932,5852,5544,11396
4113254,3236,3124,6360,849,826,1675
4113304,14992,15785,30777,3886,4080,7966
4113403,2054,2091,4145,515,481,996
4113429,1962,2011,3973,417,432,849
4113452,2792,2569,5361,641,554,1195
4113502,10447,10754,21201,2721,2701,5422
4113601,2234,2167,4401,555,516,1071
4113700,243059,263642,506701,64672,66463,131135
4113734,3736,3579,7315,965,925,1890
4113759,2559,2601,5160,547,553,1100
4113809,2261,2331,4592,546,517,1063
4113908,6699,6274,12973,1746,1570,3316
4114005,6947,7014,13961,1759,1635,3394
4114104,9853,9928,19781,2598,2487,5085
4114203,16035,16623,32658,4027,3989,8016
4114302,11315,10905,22220,2797,2715,5512
4114351,1680,1447,3127,403,347,750
4114401,8439,8609,17048,2202,2300,4502
4114500,6527,6642,13169,1652,1688,3340
4114609,22833,23986,46819,6094,6065,12159
4114708,2993,2963,5956,721,676,1397
4114807,15795,16164,31959,4074,4051,8125
4114906,4500,4363,8863,1103,1090,2193
4115002,3533,3325,6858,886,812,1698
4115101,5113,5111,10224,1291,1241,2532
4115200,171724,185353,357077,48341,48895,97236
4115309,3116,3152,6268,805,774,1579
4115358,2840,2844,5684,672,623,1295
4115408,6909,6991,13900,1747,1683,3430
4115457,2612,2369,4981,605,567,1172
4115507,2288,2315,4603,603,584,1187
4115606,7968,8110,16078,2069,2052,4121
4115705,14335,15093,29428,3363.723,3443.416,6807.139
4115739,2029,1789,3818,493,437,930
4115754,4361,4194,8555,1215,1146,2361
4115804,20567,21250,41817,5755,5609,11364
4115853,2524,2522,5046,581,570,1151
4115903,1180,1147,2327,312,296,608
4116000,923,939,1862,239,214,453
4116059,5269,5205,10474,1219,1141,2360
4116109,6315,6291,12606,1447,1363,2810
4116208,7950,7768,15718,1886,1805,3691
4116307,1836,1836,3672,450,416,866
4116406,1952,1884,3836,502,437,939
4116505,718,713,1431,212,180,392
4116604,1769,1709,3478,445,413,858
4116703,5828,6038,11866,1400,1394,2794
4116802,3757,3668,7425,880,853,1733
4116901,13019,13596,26615,3206,3176,6382
4116950,2657,2441,5098,652.0375,603.0654,1255.103
4117008,4034,4113,8147,936,966,1902
4117057,5691,5550,11241,1397,1356,2753
4117107,6425,6642,13067,1658,1658,3316
4117206,2691,2812,5503,630,649,1279
4117214,1896,2012,3908,464,471,935
4117222,3791,3835,7626,913,883,1796
4117255,5225,5152,10377,1300,1298,2598
4117271,3814,3584,7398,838,814,1652
4117297,1485,1342,2827,345,314,659
4117305,12078,11302,23380,2906,2780,5686
4117404,1705,1675,3380,452.8948,394.7824,847.6772
4117453,2867,2825,5692,730,715,1445
4117503,17822,18114,35936,4894,4793,9687
4117602,21183,21705,42888,5814,5776,11590
4117701,16046,16077,32123,4311,4139,8450
4117800,7513,7352,14865,1871,1759,3630
4117909,13997,14686,28683,3728,3788,7516
4118006,5851,5921,11772,1634,1503,3137
4118105,5115,5135,10250,1319,1355,2674
4118204,69306,71163,140469,18052.31,18417.99,36470.3
4118303,1383,1408,2791,388,377,765
4118402,39282,42308,81590,9995,10194,20189
4118451,2368,2454,4822,596,582,1178
4118501,34984,37386,72370,9888,10076,19964
4118600,2802,2632,5434,676,630,1306
4118709,3633,3280,6913,922,811,1733
4118808,6731,6893,13624,1690,1691,3381
4118857,2825,2828,5653,684,671,1355
4118907,5004,5204,10208,1274,1254,2528
4119004,3401,3360,6761,790,715,1505
4119103,5759,5477,11236,1528,1449,2977
4119152,56809,60199,117008,15577,15906,31483
4119202,3165,3050,6215,788,745,1533
4119251,1369,1256,2625,308,290,598
4119301,15181,15027,30208,3887,3910,7797
4119400,11620,11804,23424,2961,2956,5917
4119509,48194,45013,93207,13875,12440,26315
4119608,16250,16388,32638,4109,4107,8216
4119657,1441,1373,2814,351,316,667
4119707,2070,2025,4095,537,496,1033
4119806,6849,6805,13654,1656,1520,3176
4119905,151362,160249,311611,41346.58,40326.94,81673.52
4119954,10357,10563,20920,2338,2331,4669
4120002,7036,7153,14189,1726,1648,3374
4120101,2256,2258,4514,619,565,1184
4120150,1915,1748,3663,485,444,929
4120200,1284,1246,2530,323,303,626
4120309,2061,1959,4020,507,454,961
4120333,1740,1694,3434,431,398,829
4120358,2816,2812,5628,677,624,1301
4120408,2455,2329,4784,646,576,1222
4120507,5401,5431,10832,1311,1260,2571
4120606,24891,23901,48792,6250,5820,12070
4120655,2391,2465,4856,628,605,1233
4120705,3453,3592,7045,844,856,1700
4120804,9955,9896,19851,2781,2718,5499
4120853,1850,1953,3803,436,432,868
4120903,15397,15208,30605,3942,3772,7714
4121000,5937,5792,11729,1499,1498,2997
4121109,2545,2543,5088,638,618,1256
4121208,8837,8252,17089,2241,2050,4291
4121257,2124,2010,4134,532,487,1019
4121307,1953,2002,3955,452,426,878
4121356,1414,1433,2847,343,354,697
4121406,8004,8334,16338,2091,2081,4172
4121505,7201,6975,14176,1851,1728,3579
4121604,3427,3385,6812,864,771,1635
4121703,12926,12246,25172,3303,3171,6474
4121752,3747,3560,7307,966,912,1878
4121802,5272,5406,10678,1302,1248,2550
4121901,6731,6793,13524,1582,1583,3165
4122008,7340,6753,14093,1967,1726,3693
4122107,1742,1592,3334,401,338,739
4122156,7059,6602,13661,1678,1604,3282
4122172,1962,1936,3898,506,516,1022
4122206,15546,15104,30650,4240,4222,8462
4122305,15570,15704,31274,4058,3906,7964
4122404,28459,29403,57862,7538,7383,14921
4122503,5823,5714,11537,1401,1374,2775
4122602,4564,4432,8996,1133,1080,2213
4122651,2831,2757,5588,669,625,1294
4122701,3051,3045,6096,780,755,1535
4122800,2248,2155,4403,543,475,1018
4122909,2614,2564,5178,592,578,1170
4123006,6941,6748,13689,1888,1745,3633
4123105,1906,1897,3803,431,417,848
4123204,1804,1842,3646,423,417,840
4123303,4051,4041,8092,1026,1003,2029
4123402,5118,5314,10432,1332,1293,2625
4123501,11506,11907,23413,2884,2987,5871
4123600,927,891,1818,251,190,441
4123709,4387,4373,8760,1058,947,2005
4123808,6628,6504,13132,1762,1670,3432
4123824,1959,1966,3925,430,434,864
4123857,5913,5587,11500,1485,1432,2917
4123907,6171,6264,12435,1445,1377,2822
4123956,1843,1728,3571,476,428,904
4124004,2643,2606,5249,569,587,1156
4124020,5248,5084,10332,1480,1374,2854
4124053,10197,10644,20841,2689,2804,5493
4124103,21003,21704,42707,5363,5222,10585
4124202,1346,1381,2727,318,305,623
4124301,1200,1208,2408,255,287,542
4124400,9265,9628,18893,2306,2329,4635
4124509,2663,2606,5269,705,643,1348
4124608,3254,3100,6354,870,809,1679
4124707,5846,5491,11337,1410,1317,2727
4124806,5240,5359,10599,1281,1250,2531
4124905,2925,2986,5911,734,715,1449
4125001,5678,5847,11525,1314,1312,2626
4125100,7208,6496,13704,1964,1771,3735
4125209,4546,4539,9085,1096,1141,2237
4125308,2724,2793,5517,595,591,1186
4125357,3068,2973,6041,750,678,1428
4125407,3363,3148,6511,750,732,1482
4125456,1926,1904,3830,466,487,953
4125506,130597,133613,264210,35897,36525,72422
4125555,1054,1044,2098,248,227,475
4125605,20781,20476,41257,5345,5413,10758
4125704,12857,12912,25769,3365,3364,6729
4125753,3292,3199,6491,792,771,1563
4125803,5115,5052,10167,1345,1295,2640
4125902,1261,1230,2491,290,268,558
4126009,4256,4370,8626,1101,1100,2201
4126108,2696,2653,5349,722,650,1372
4126207,3507,3229,6736,872,778,1650
4126256,40830,42017,82847,11006.7,11133.88,22140.58
4126272,2537,2491,5028,674,658,1332
4126306,9463,8951,18414,2515,2355,4870
4126355,2229,2339,4568,487,530,1017
4126405,2896,2921,5817,627,626,1253
4126504,7748,7890,15638,1949,1857,3806
4126603,9206,9248,18454,2283,2223,4506
4126652,1713,1681,3394,358,346,704
4126678,6276,5986,12262,1547,1540,3087
4126702,2309,2355,4664,621,580,1201
4126801,7305,7293,14598,1965,1862,3827
4126900,2918,2918,5836,662,640,1302
4127007,5332,4951,10283,1384,1276,2660
4127106,34386,35486,69872,9069.578,9001.921,18071.5
4127205,7822,7954,15776,2057,2044,4101
4127304,7609,7612,15221,1918,1856,3774
4127403,8295,8464,16759,2035,1988,4023
4127502,9804,9540,19344,2413,2420,4833
4127601,7546,6991,14537,1845,1728,3573
4127700,58337,60976,119313,16556,16532,33088
4127809,4530,4261,8791,1071,979,2050
4127858,5994,5830,11824,1476,1399,2875
4127882,3271,2985,6256,899,868,1767
4127908,4441,4254,8695,1123,1004,2127
4127957,4051,3946,7997,844,842,1686
4127965,6980,6831,13811,1884,1779,3663
4128005,10504,11054,21558,2532,2529,5061
4128104,48788,51888,100676,13120,13442,26562
4128203,25818,26917,52735,6686,6772,13458
4128302,1232,1234,2466,304,307,611
4128401,5681,5791,11472,1322,1299,2621
4128500,9511,9787,19298,2277,2334,4611
4128534,5144,4813,9957,1408,1307,2715
4128559,4411,4562,8973,1102,1050,2152
4128609,3938,3940,7878,969,884,1853
4128625,1619,1587,3206,363,384,747
4128633,2980,2747,5727,769,674,1443
4128658,1999,1951,3950,475,468,943
4128708,3230,3283,6513,820,757,1577
4128807,2998,3014,6012,689,665,1354
4200051,1382,1271,2653,310,293,603
4200101,8628,8472,17100,2165,2177,4342
4200200,4699,4624,9323,1255,1225,2480
4200309,2497,2407,4904,606,625,1231
4200408,3554,3407,6961,847,824,1671
4200507,3124,2986,6110,856,719,1575
4200556,1279,1145,2424,294,258,552
4200606,2810,2738,5548,752,696,1448
4200705,4784,4626,9410,1280,1200,2480
4200754,1005,1000,2005,197,182,379
4200804,3231,3149,6380,759,732,1491
4200903,2765,2485,5250,671,563,1234
4201000,4340,4283,8623,1065,967,2032
4201109,1675,1539,3214,361,326,687
4201208,3757,3701,7458,924,954,1878
4201257,4866,4734,9600,1298,1242,2540
4201273,2133,2060,4193,465,448,913
4201307,12648,12162,24810,3473,3379,6852
4201406,30138,31172,61310,8220,8154,16374
4201505,3924,3829,7753,1106,965,2071
4201604,1747,1755,3502,411,390,801
4201653,1229,1031,2260,305,250,555
4201703,3680,3732,7412,998,923,1921
4201802,1661,1639,3300,414,420,834
4201901,2824,2725,5549,714,707,1421
4201950,4743,4843,9586,1086,1108,2194
4202008,51393,56696,108089,14899,15508,30407
4202057,4172,4258,8430,780,791,1571
4202073,4092,4142,8234,949,926,1875
4202081,1535,1371,2906,338,295,633
4202099,976,902,1878,202.0784,182.9216,385
4202107,11103,11283,22386,2645,2631,5276
4202131,3104,2900,6004,773,761,1534
4202156,1358,1277,2635,336,292,628
4202206,5280,5056,10336,1364,1262,2626
4202305,28665,29541,58206,8098,8101,16199
4202404,151542,157469,309011,42845.71,41957.51,84803.22
4202438,1700,1590,3290,404,378,782
4202453,7194,7099,14293,1937,1856,3793
4202503,2253,2142,4395,565,548,1113
4202537,1253,1273,2526,310,324,634
4202578,1078,1054,2132,241,226,467
4202602,4513,4429,8942,1168,1161,2329
4202701,2278,2190,4468,606,583,1189
4202800,14533,14485,29018,4142,4138,8280
4202859,1765,1692,3457,468,424,892
4202875,1452,1398,2850,330,295,625
4202909,52400,53103,105503,15770,15174,30944
4203006,35040,35722,70762,9377,9323,18700
4203105,3142,3077,6219,761,731,1492
4203154,1749,1638,3387,402,430,832
4203204,31159,31202,62361,8827,8780,17607
4203253,1431,1322,2753,318,284,602
4203303,5970,5778,11748,1419,1390,2809
4203402,3850,3633,7483,902,824,1726
4203501,4686,4684,9370,1198,1185,2383
4203600,16257,16567,32824,4330,4184,8514
4203709,5372,5231,10603,1474,1412,2886
4203808,26044,26721,52765,6793,6709,13502
4203907,10233,10536,20769,2718,2878,5596
4203956,10499,11175,21674,2880,2917,5797
4204004,4763,4792,9555,1266,1241,2507
4204103,2219,2192,4411,527,484,1011
4204152,1395,1376,2771,342,332,674
4204178,1873,1708,3581,422,398,820
4204194,1425,1337,2762,329,335,664
4204202,90626,92904,183530,26862,27178,54040
4204251,7523,7636,15159,2183,2047,4230
4204301,33771,34850,68621,8794,8646,17440
4204350,1921,1846,3767,541,511,1052
4204400,5189,5024,10213,1375,1233,2608
4204459,1262,1196,2458,305,260,565
4204509,7002,6850,13852,1913,1768,3681
4204558,7376,7409,14785,1881,1872,3753
4204608,94607,97701,192308,27582,26407,53989
4204707,5258,5355,10613,1358,1287,2645
4204756,1004,878,1882,235,205,440
4204806,18521,19227,37748,4585,4669,9254
4204905,4356,4278,8634,1071,1015,2086
4205001,7414,7397,14811,1833,1819,3652
4205100,1909,1812,3721,471,440,911
4205159,1794,1810,3604,428,398,826
4205175,1557,1461,3018,395,392,787
4205191,1066,984,2050,287,241,528
4205209,2148,2204,4352,524,450,974
4205308,5357,5304,10661,1455,1397,2852
4205357,827,761,1588,189.6166,166.3834,356
4205407,203047,218193,421240,59461.78,58604.28,118066.1
4205431,1327,1274,2601,325,304,629
4205456,11307,11241,22548,3356,3276,6632
4205506,17161,17392,34553,4458,4498,8956
4205555,1288,1186,2474,297,265,562
4205605,1720,1752,3472,395,427,822
4205704,9127,9011,18138,2240,2171,4411
4205803,7540,7221,14761,2049,1974,4023
4205902,28678,29303,57981,8263,8054,16317
4206009,6641,6358,12999,1708,1588,3296
4206108,3235,2988,6223,882,776,1658
4206207,5286,5349,10635,1358,1327,2685
4206306,9351,9079,18430,2667,2576,5243
4206405,5300,5198,10498,1292,1240,2532
4206504,17840,17332,35172,5404,5134,10538
4206603,2401,2507,4908,608,596,1204
4206652,2471,2208,4679,628,581,1209
4206702,10497,10742,21239,2855,2764,5619
4206751,981,964,1945,215,233,448
4206801,1775,1598,3373,374,328,702
4206900,8666,8664,17330,2340,2176,4516
4207007,29303,29530,58833,8276,7971,16247
4207106,6227,6128,12355,1698,1651,3349
4207205,5865,5807,11672,1220,1117,2337
4207304,19805,20365,40170,4928,4865,9793
4207403,2890,2817,5707,754,715,1469
4207502,27431,27423,54854,7748,7446,15194
4207577,1393,1346,2739,271.6,304,575.6
4207601,2366,2386,4752,527,522,1049
4207650,4258,4151,8409,1036,979,2015
4207684,3473,3325,6798,898,859,1757
4207700,3665,3555,7220,919,861,1780
4207759,2172,2081,4253,478,424,902
4207809,4850,4681,9531,1265,1186,2451
4207858,1072,1024,2096,281,240,521
4207908,5346,5102,10448,1330,1344,2674
4208005,3218,3208,6426,790,761,1551
4208104,10409,9892,20301,2666,2494,5160
4208203,90111,93262,183373,25718,25754,51472
4208302,22391,23406,45797,5990,6090,12080
4208401,7858,7551,15409,2152,2054,4206
4208450,7447,7316,14763,1690,1564,3254
4208500,11095,11155,22250,3055,3032,6087
4208609,2013,2028,4041,497,469,966
4208708,5262,5347,10609,1357,1307,2664
4208807,8625,8665,17290,2207,2069,4276
4208906,71801,71322,143123,21586,20380,41966
4208955,900,866,1766,225,193,418
4209003,13008,14012,27020,3473,3522,6995
4209102,255756,259532,515288,72635.26,69393.55,142028.8
4209151,2392,2329,4721,593,598,1191
4209177,1094,1054,2148,252,226,478
4209201,1096,1103,2199,229,236,465
4209300,75952,80775,156727,20539,20561,41100
4209409,25305,26257,51562,6161,6032,12193
4209458,756,734,1490,179,175,354
4209508,3001,3003,6004,785,775,1560
4209607,7187,7180,14367,1954,1891,3845
4209706,6081,5757,11838,1507,1447,2954
4209805,1754,1611,3365,449,389,838
4209854,2393,2249,4642,535,523,1058
4209904,5126,5118,10244,1337,1335,2672
4210001,5383,5055,10438,1578,1481,3059
4210035,2740,2860,5600,687,624,1311
4210050,948,878,1826,253,201,454
4210100,26251,26661,52912,6818,6475,13293
4210209,1672,1607,3279,405,397,802
4210308,3799,3680,7479,978,902,1880
4210407,3248,3156,6404,909,846,1755
4210506,10907,11194,22101,2946,2915,5861
4210555,1135,1068,2203,248,235,483
4210605,7449,7225,14674,1962,1867,3829
4210704,1475,1364,2839,346,338,684
4210803,3458,3542,7000,909,932,1841
4210852,1273,1240,2513,281,268,549
4210902,2070,1975,4045,527,464,991
4211009,5422,4809,10231,1517,1272,2789
4211058,4740,4572,9312,1172,1158,2330
4211108,4283,4063,8346,1052,1020,2072
4211207,8078,8048,16126,2361,2209,4570
4211256,1513,1377,2890,412,386,798
4211306,30158,30398,60556,8300,8203,16503
4211405,2205,2070,4275,579,508,1087
4211454,2210,2057,4267,518,468,986
4211504,6181,6009,12190,1755,1536,3291
4211603,6719,6590,13309,1838,1881,3719
4211652,1450,1300,2750,319,245,564
4211702,10634,10759,21393,2887,2821,5708
4211751,8262,8075,16337,2141,2030,4171
4211801,3671,3701,7372,939,881,1820
4211850,1150,1121,2271,289,280,569
4211876,939,824,1763,229,176,405
4211892,1232,1121,2353,289.1786,239.7309,528.9094
4211900,68436,68898,137334,19232,19149,38381
4212007,3957,3808,7765,1059,971,2030
4212056,1221,1152,2373,280,258,538
4212106,8018,8002,16020,1898,1842,3740
4212205,9172,8756,17928,2447,2243,4690
4212239,2091,1989,4080,457,432,889
4212254,3352,3275,6627,899.2614,844.1626,1743.424
4212270,2241,2184,4425,560,534,1094
4212304,3404,3288,6692,905,825,1730
4212403,2098,2009,4107,539,460,999
4212502,12538,12603,25141,3133,3065,6198
4212601,1484,1504,2988,338,308,646
4212700,3165,2966,6131,796,692,1488
4212809,8521,8557,17078,2138,2050,4188
4212908,8177,8155,16332,2457,2404,4861
4213005,1616,1531,3147,417,415,832
4213104,2373,2413,4786,578,595,1173
4213153,1383,1271,2654,357,293,650
4213203,13904,13855,27759,3681,3529,7210
4213302,2454,2440,4894,589,577,1166
4213351,1644,1659,3303,438,445,883
4213401,5534,5497,11031,1489,1380,2869
4213500,7998,8085,16083,2084,2019,4103
4213609,16448,17045,33493,4104,4116,8220
4213708,7504,7306,14810,2018,1959,3977
4213807,3658,3609,7267,913,878,1791
4213906,881,844,1725,188,172,360
4214003,7404,7483,14887,1979,1898,3877
4214102,1167,1117,2284,305,262,567
4214151,1421,1337,2758,370,365,735
4214201,5168,5080,10248,1384,1324,2708
4214300,1398,1350,2748,309,317,626
4214409,3153,2990,6143,784,699,1483
4214508,3179,3013,6192,790,731,1521
4214607,3599,3491,7090,897,804,1701
4214706,5268,5016,10284,1333,1185,2518
4214805,29978,31220,61198,8354,8210,16564
4214904,2294,2152,4446,637,560,1197
4215000,19977,19869,39846,5194,5058,10252
4215059,1245,1191,2436,304,283,587
4215075,2498,2340,4838,572,555,1127
4215109,5487,5435,10922,1377,1284,2661
4215208,2793,2758,5551,564,549,1113
4215307,3772,3598,7370,995,916,1911
4215356,2040,1921,3961,466,460,926
4215406,2189,2112,4301,591,570,1161
4215455,5322,5078,10400,1567,1497,3064
4215505,7849,7908,15757,2053,2141,4194
4215554,1236,1146,2382,300,256,556
4215604,1092,973,2065,283,250,533
4215653,4050,4004,8054,1014,972,1986
4215679,4700,4067,8767,1314,1056,2370
4215687,1493,1403,2896,350,313,663
4215695,754,711,1465,169.1428,177.8572,347
4215703,9984,9839,19823,2695,2596,5291
4215752,1407,1270,2677,324,288,612
4215802,37239,37562,74801,10210,10016,20226
4215901,1551,1457,3008,334,275,609
4216008,5171,5120,10291,1309,1300,2609
4216057,2850,2162,5012,783,561,1344
4216107,4780,4711,9491,1177,1136,2313
4216206,21182,21338,42520,5267,5086,10353
4216255,3098,2938,6036,749,658,1407
4216305,13287,12973,26260,4036,3894,7930
4216354,1790,1645,3435,464,413,877
4216404,3530,3472,7002,903,873,1776
4216503,12434,12378,24812,3131,3078,6209
4216602,101392,108412,209804,29132.22,29336.21,58468.43
4216701,6892,6792,13684,1720,1658,3378
4216800,4801,4472,9273,986,973,1959
4216909,10828,10964,21792,2834,2926,5760
4217006,5625,5368,10993,1704,1546,3250
4217105,1660,1549,3209,396,358,754
4217154,979,925,1904,212,193,405
4217204,17650,18656,36306,4887,4995,9882
4217253,2988,1716,4704,1041.272,385.7421,1427.014
4217303,4618,4398,9016,1261,1161,2422
4217402,7801,7515,15316,2216,2143,4359
4217501,8525,8411,16936,2277,2154,4431
4217550,1634,1651,3285,419,386,805
4217600,6480,6518,12998,1783,1653,3436
4217709,13072,13541,26613,3601,3615,7216
4217758,1437,1329,2766,324,284,608
4217808,8690,8570,17260,2221,2158,4379
4217907,4470,4204,8674,1120,1026,2146
4217956,902,855,1757,213,197,410
4218004,15494,15466,30960,4394,4246,8640
4218103,2693,2615,5308,692,676,1368
4218202,18244,18530,36774,4959,4755,9714
4218251,3612,3555,7167,954,993,1947
4218301,9057,9072,18129,2429,2321,4750
4218350,1789,1738,3527,451,442,893
4218400,3451,3425,6876,923,925,1848
4218509,3150,3191,6341,915,880,1795
4218608,3268,3285,6553,852,825,1677
4218707,47114,50121,97235,13014,12850,25864
4218756,2368,2265,4633,581,518,1099
4218806,5850,6004,11854,1589,1615,3204
4218855,1475,1435,2910,346,327,673
4218905,5396,5303,10699,1379,1317,2696
4218954,1274,1208,2482,281,258,539
4219002,9935,10288,20223,2654,2565,5219
4219101,1785,1747,3532,462,435,897
4219150,1446,1362,2808,313,317,630
4219176,2428,2365,4793,620,596,1216
4219200,3258,3032,6290,848,775,1623
4219309,23279,23909,47188,6560,6564,13124
4219358,2770,2437,5207,726,589,1315
4219408,1827,1773,3600,472,420,892
4219507,21581,22547,44128,6011,5952,11963
4219606,2160,1982,4142,511,447,958
4219705,12776,12937,25713,3422,3475,6897
4219853,1537,1454,2991,392,368,760
4300034,2303,2091,4394,524,465,989
4300059,1879,1843,3722,459,442,901
4300109,8349,8373,16722,1983,1923,3906
4300208,3585,3670,7255,781,746,1527
4300307,3512,3533,7045,624,610,1234
4300406,38051,39602,77653,9534,9174,18708
4300455,2149,2152,4301,392,376,768
4300471,1041,1026,2067,235.8916,218.9273,454.8189
4300505,4129,3898,8027,901,790,1691
4300554,944,904,1848,201,191,392
4300570,1500,1417,2917,330,310,640
4300604,95080,100593,195673,25783,25809,51592
4300638,3281,3072,6353,738,758,1496
4300646,3732,3591,7323,891,863,1754
4300661,620,596,1216,141.8568,106.1432,248
4300703,3025,3048,6073,669,616,1285
4300802,6405,6428,12833,1502,1426,2928
4300851,1854,1839,3693,376,343,719
4300877,2456,2408,4864,610,585,1195
4300901,3340,3225,6565,749,642,1391
4301008,9353,9430,18783,2416,2221,4637
4301057,3833,3907,7740,837,778,1615
4301073,1414,1316,2730,356,290,646
4301107,6635,6971,13606,1540,1586,3126
4301206,6384,6264,12648,1611,1543,3154
4301305,9174,9296,18470,2097,2078,4175
4301404,5134,5091,10225,1285,1209,2494
4301503,3487,3609,7096,746,706,1452
4301552,1807,1858,3665,374,334,708
4301602,55804,60990,116794,14268,14312,28580
4301636,5344,5512,10856,1051,1078,2129
4301651,2912,2829,5741,758,680,1438
4301701,3296,3233,6529,772,719,1491
4301750,3741,3277,7018,909,787,1696
4301800,2691,2666,5357,623,592,1215
4301859,1550,1539,3089,383,349,732
4301875,2128,1884,4012,526,491,1017
4301909,6253,6319,12572,1453,1393,2846
4301925,1049,954,2003,227,180,407
4301958,1177,1190,2367,274,281,555
4302006,5729,5404,11133,1290,1279,2569
4302055,1195,1112,2307,301,275,576
4302105,52645,54633,107278,14439.5,14124.28,28563.78
4302154,1056,1058,2114,248,253,501
4302204,3295,3279,6574,764,744,1508
4302220,1257,1184,2441,261,256,517
4302238,1243,1182,2425,290,281,571
4302253,1469,1307,2776,305,232,537
4302303,5703,5816,11519,1294,1296,2590
4302352,6029,5760,11789,1633,1562,3195
4302378,1167,1161,2328,280,248,528
4302402,5655,5817,11472,1486,1389,2875
4302451,3937,3736,7673,1010,990,2000
4302501,3509,3375,6884,713,719,1432
4302584,1100,1100,2200,220,212,432
4302600,1866,1836,3702,412,401,813
4302659,2398,2277,4675,536,497,1033
4302709,10032,10374,20406,2497,2444,4941
4302808,16329,17361,33690,3694,3713,7407
4302907,6836,6840,13676,1622,1546,3168
4303004,40378,43449,83827,9575,9382,18957
4303103,57173,61105,118278,15109,15196,30305
4303202,2417,2451,4868,585,520,1105
4303301,2532,2422,4954,543,492,1035
4303400,2585,2486,5071,584,530,1114
4303509,30900,31864,62764,7681,7393,15074
4303558,1291,1301,2592,301,282,583
4303608,3350,3192,6542,805,772,1577
4303673,1674,1573,3247,320,312,632
4303707,3056,3061,6117,621,568,1189
4303806,2650,2856,5506,617,607,1224
4303905,29471,30603,60074,8057,7860,15917
4304002,2685,2774,5459,615,611,1226
4304101,1754,1740,3494,389,370,759
4304200,14752,15419,30171,3418,3400,6818
4304309,3318,3217,6535,715,618,1333
4304358,4481,4290,8771,1140,1151,2291
4304408,19120,20109,39229,4967,5098,10065
4304507,26856,26403,53259,6057,5734,11791
4304606,155936,167891,323827,41014,41570,82584
4304614,959,848,1807,205,164,369
4304622,943,811,1754,214,175,389
4304630,20616,21424,42040,5375,5351,10726
4304655,1628,1476,3104,363,329,692
4304663,11962,12336,24298,2949,3046,5995
4304671,1935,1955,3890,470,451,921
4304689,5848,5764,11612,1433,1413,2846
4304697,1353,1283,2636,297,279,576
4304705,28280,31037,59317,7343,7397,14740
4304713,3798,3514,7312,751,707,1458
4304804,12662,12530,25192,3318,3210,6528
4304853,834,773,1607,167.5791,161.4209,329
4304903,4243,4408,8651,1057,947,2004
4304952,1517,1490,3007,302,277,579
4305009,4590,4733,9323,997,952,1949
4305108,213612,221952,435564,59971,58320,118291
4305116,1541,1424,2965,337,288,625
4305124,3213,3189,6402,617,617,1234
4305132,2225,2229,4454,485,459,944
4305157,1209,1208,2417,227.7333,266,493.7333
4305173,5355,4913,10268,1320,1288,2608
4305207,6617,6672,13289,1581,1518,3099
4305306,4593,4784,9377,1090,1031,2121
4305355,19533,15787,35320,6180,3779,9959
4305371,1728,1743,3471,402,397,799
4305405,1975,2069,4044,436,447,883
4305439,2921,2996,5917,657,686,1343
4305447,2603,2341,4944,641,586,1227
4305454,6245,6423,12668,1256,1247,2503
4305504,2512,2410,4922,617,527,1144
4305587,1208,1212,2420,251,237,488
4305603,1727,1823,3550,398,364,762
4305702,3219,3333,6552,775,791,1566
4305801,4776,4976,9752,1182,1140,2322
4305835,791,737,1528,131.5205,102.4795,234
4305850,1255,1202,2457,223.0667,204,427.0667
4305871,1219,1240,2459,249,235,484
4305900,3802,3946,7748,804,887,1691
4305934,894,831,1725,167,124,291
4305959,2033,1884,3917,470,366,836
4305975,1388,1438,2826,338,360,698
4306007,6913,7171,14084,1486,1464,2950
4306056,3686,3594,7280,847,831,1678
4306072,1441,1385,2826,308,307,615
4306106,29743,33078,62821,7492,7769,15261
4306130,1101,1040,2141,237,215,452
4306205,6157,6163,12320,1427,1399,2826
4306304,2410,2273,4683,544,523,1067
4306320,1604,1586,3190,348,311,659
4306353,1469,1397,2866,270,253,523
4306379,1579,1485,3064,299.0147,290.729,589.7437
4306403,13653,13919,27572,3874,3831,7705
4306429,1080,1077,2157,245,249,494
4306452,1653,1625,3278,383,315,698
4306502,7398,6982,14380,1759,1692,3451
4306551,1341,1209,2550,295,259,554
4306601,19107,19791,38898,4482,4367,8849
4306700,1678,1723,3401,414,405,819
4306734,2646,2667,5313,556,491,1047
4306759,1035,995,2030,218,206,424
4306767,16999,17344,34343,4375,4391,8766
4306809,9932,10578,20510,2451,2499,4950
4306908,12322,12212,24534,2740,2630,5370
4306924,742,785,1527,175.662,194.338,370
4306932,4415,4523,8938,946,906,1852
4306957,1556,1524,3080,324,308,632
4306973,1490,1480,2970,378,350,728
4307005,46224,49863,96087,12512,12785,25297
4307054,1562,1526,3088,331,332,663
4307104,3483,3270,6753,690,699,1389
4307203,2622,2541,5163,603,580,1183
4307302,3920,3958,7878,846,901,1747
4307401,1572,1596,3168,356,349,705
4307450,1650,1622,3272,305,285,590
4307500,7532,7708,15240,1841,1811,3652
4307559,2951,3060,6011,728,702,1430
4307609,21035,21539,42574,5642,5562,11204
4307708,38973,41782,80755,10287.9,10206.41,20494.3
4307807,15119,15500,30619,4009,3801,7810
4307815,1846,1782,3628,449,435,884
4307831,1415,1383,2798,267,253,520
4307864,1300,1279,2579,241,253,494
4307906,31303,32332,63635,8730,8339,17069
4308003,3274,3398,6672,770,807,1577
4308052,1283,1284,2567,274,265,539
4308078,1856,1841,3697,438,441,879
4308102,6161,6198,12359,1682,1546,3228
4308201,13552,13574,27126,3535,3386,6921
4308250,1081,937,2018,217,171,388
4308300,5461,5258,10719,1278,1212,2490
4308409,3570,3444,7014,741,725,1466
4308433,1265,1214,2479,242,212,454
4308458,2241,2334,4575,503,551,1054
4308508,14128,14715,28843,3867,3913,7780
4308607,15221,15468,30689,4059,3898,7957
4308656,1682,1552,3234,349,350,699
4308706,2832,3030,5862,614,624,1238
4308805,4233,4214,8447,926,862,1788
4308854,889,788,1677,208,192,400
4308904,7849,8305,16154,1884,1964,3848
4309001,8338,8737,17075,1853,1922,3775
4309050,3536,3355,6891,832,798,1630
4309100,15673,16600,32273,3993,3977,7970
4309126,1151,1118,2269,246,240,486
4309159,2044,1926,3970,502,500,1002
4309209,124880,130780,255660,33121,33288,66409
4309258,806,792,1598,178,151,329
4309308,46153,49051,95204,12055,12199,24254
4309407,11124,11690,22814,2846,2898,5744
4309506,3951,4164,8115,862,837,1699
4309555,2151,2103,4254,508,509,1017
4309571,1543,1411,2954,395,348,743
4309605,8946,9402,18348,2254,2214,4468
4309654,3124,2919,6043,741,722,1463
4309704,2387,2532,4919,509,522,1031
4309753,2230,2141,4371,550,538,1088
4309803,2290,2420,4710,509,471,980
4309902,3588,3583,7171,824,816,1640
4309951,2063,1998,4061,458,461,919
4310009,9472,9838,19310,2419,2327,4746
4310108,15461,16199,31660,4201,4298,8499
4310207,38112,40803,78915,9734,9734,19468
4310306,2055,2047,4102,460,485,945
4310330,8663,9007,17670,1929,1973,3902
4310363,1495,1528,3023,301,292,593
4310405,3293,3325,6618,677,661,1338
4310413,1148,1119,2267,243,243,486
4310439,3083,2933,6016,691,593,1284
4310462,972,972,1944,197.7019,202.2981,400
4310504,4075,4003,8078,923,868,1791
4310538,2543,2467,5010,593,569,1162
4310553,1778,1663,3441,377,323,700
4310579,1233,1111,2344,278,263,541
4310603,19034,19125,38159,4898,4736,9634
4310652,1340,1244,2584,262,245,507
4310702,2178,1993,4171,467,385,852
4310751,1097,1059,2156,239,218,457
4310801,9801,10073,19874,2593,2538,5131
4310850,2081,2017,4098,403,414,817
4310876,1283,1224,2507,292,291,583
4310900,1781,1852,3633,420,421,841
4311007,13588,14343,27931,3174.121,3111.641,6285.762
4311106,5738,5735,11473,1309,1175,2484
4311122,2142,2035,4177,405,434,839
4311130,1884,1691,3575,413,381,794
4311155,4306,4025,8331,952,889,1841
4311205,9626,9953,19579,2330,2350,4680
4311239,1403,1259,2662,328,283,611
4311254,3195,2990,6185,724,688,1412
4311270,776,822,1598,162.2368,151.9123,314.1491
4311304,13564,13961,27525,3235,3074,6309
4311403,34731,36714,71445,9673,9817,19490
4311429,1253,1234,2487,270,285,555
4311502,3775,3904,7679,817,841,1658
4311601,2949,2831,5780,686,617,1303
4311627,2679,2548,5227,741,713,1454
4311643,808,816,1624,160,171,331
4311700,2757,2753,5510,578,619,1197
4311718,2418,2320,4738,538,526,1064
4311734,1551,1452,3003,384,335,719
4311759,3556,3516,7072,750,762,1512
4311775,3523,3382,6905,727,711,1438
4311791,1272,1255,2527,260,237,497
4311809,18030,18334,36364,5048,4880,9928
4311908,2555,2579,5134,575,529,1104
4311981,1970,1798,3768,408,391,799
4312005,1133,1077,2210,234,214,448
4312054,2039,2029,4068,443,398,841
4312104,2575,2536,5111,557,507,1064
4312138,1292,1178,2470,293,258,551
4312153,1937,1928,3865,438,438,876
4312179,902,897,1799,157.3541,152.6459,310
4312203,2467,2444,4911,542,507,1049
4312252,3778,3853,7631,905,908,1813
4312302,2413,2442,4855,524,544,1068
4312351,794,748,1542,172.0635,135.9365,308
4312377,1661,1441,3102,348,275,623
4312385,1345,1325,2670,307,272,579
4312401,29245,30170,59415,7862,7480,15342
4312427,1396,1353,2749,310,284,594
4312443,1617,1565,3182,363,366,729
4312450,3135,3092,6227,664,622,1286
4312476,2849,2827,5676,699,650,1349
4312500,6187,5937,12124,1371,1320,2691
4312609,2300,2491,4791,482,474,956
4312617,1535,1453,2988,362,327,689
4312625,923,890,1813,231,224,455
4312658,7855,8081,15936,2121,2003,4124
4312674,862,859,1721,173,177,350
4312708,5932,6142,12074,1496,1480,2976
4312757,1598,1584,3182,378,374,752
4312807,1957,2044,4001,523,488,1011
4312906,4480,4360,8840,1129,995,2124
4312955,981,979,1960,208,198,406
4313003,1629,1555,3184,394,303,697
4313011,1405,1346,2751,311,292,603
4313037,2306,2365,4671,576,592,1168
4313060,9072,9274,18346,2463,2526,4989
4313086,1258,1192,2450,287,236,523
4313102,3217,3125,6342,823,771,1594
4313201,9370,9675,19045,2240,2274,4514
4313300,11303,11527,22830,2990,2917,5907
4313334,1246,1191,2437,254,243,497
4313359,1708,1635,3343,365,330,695
4313375,11441,11275,22716,2976,2849,5825
4313391,1946,1909,3855,432,439,871
4313409,115766,123174,238940,30869.56,30529.73,61399.3
4313425,1948,1977,3925,353,343,696
4313441,1191,1086,2277,249,223,472
4313466,861,896,1757,190,202,392
4313490,2032,1946,3978,446,449,895
4313508,20157,20749,40906,5042.645,5105.19,10147.84
4313607,2111,2132,4243,443,423,866
4313656,5462,5507,10969,1206,1150,2356
4313706,16641,17687,34328,4189,4306,8495
4313805,3494,3426,6920,848,831,1679
4313904,19013,19045,38058,5338,4897,10235
4313953,4909,4986,9895,1117,1116,2233
4314001,3451,3361,6812,875,783,1658
4314027,3694,3642,7336,829,785,1614
4314035,1784,1727,3511,455,410,865
4314050,25449,26053,51502,6859,6958,13817
4314068,2678,2476,5154,628,610,1238
4314076,2996,3015,6011,732,689,1421
4314100,88050,96776,184826,24587.29,25391.38,49978.68
4314134,1126,1070,2196,217,206,423
4314159,4050,3994,8044,947,869,1816
4314175,1161,1051,2212,263,246,509
4314209,3826,3985,7811,812,814,1626
4314308,2008,1965,3973,509,433,942
4314407,154198,174077,328275,40287,41800,82087
4314423,2594,2588,5182,615,675,1290
4314456,1274,1239,2513,306,300,606
4314464,1110,1020,2130,244,212,456
4314472,2314,2157,4471,522,497,1019
4314498,2277,2220,4497,598,544,1142
4314506,6381,6399,12780,1438,1397,2835
4314555,1398,1359,2757,277,236.1333,513.1334
4314605,10108,9733,19841,2071,1983,4054
4314704,5209,5315,10524,1215,1218,2433
4314753,1023,994,2017,214,208,422
4314779,1984,1873,3857,494,450,944
4314787,924,826,1750,194.8162,157.1838,352
4314803,15515,15405,30920,4036,3927,7963
4314902,653787,755564,1409351,173249,178427,351676
4315008,2698,2715,5413,467,470,937
4315057,1264,1278,2542,265,242,507
4315073,936,916,1852,150.1751,109.0482,259.2234
4315107,5300,5258,10558,1161,1204,2365
4315131,953,922,1875,208,215,423
4315149,1310,1174,2484,353,269,622
4315156,3183,2980,6163,740,683,1423
4315172,1079,921,2000,217,174,391
4315206,2097,2044,4141,478,423,901
4315305,11228,11793,23021,2659,2554,5213
4315313,890,885,1775,209,210,419
4315321,1447,1263,2710,320,304,624
4315354,1799,1854,3653,374,382,756
4315404,5210,5012,10222,1348,1252,2600
4315453,1071,1084,2155,203,192,395
4315503,7815,8034,15849,1801,1791,3592
4315552,1860,1756,3616,378,380,758
4315602,94983,102245,197228,24574,24754,49328
4315701,18318,19273,37591,4425,4361,8786
4315750,2203,2127,4330,505,495,1000
4315800,5090,5194,10284,1259,1183,2442
4315909,2846,2897,5743,664.137,658.8168,1322.954
4315958,1318,1228,2546,253,237,490
4316006,9767,9718,19485,2467,2358,4825
4316105,5009,5212,10221,1255,1264,2519
4316204,2718,2800,5518,506,503,1009
4316303,3622,3581,7203,752,785,1537
4316402,19311,20396,39707,4563,4554,9117
4316428,1339,1256,2595,273,281,554
4316436,1390,1479,2869,316,299,615
4316451,5878,6002,11880,1387,1449,2836
4316477,1377,1292,2669,290,251,541
4316501,3412,3335,6747,914,871,1785
4316600,7604,7769,15373,1857,1700,3557
4316709,4341,4488,8829,1074,1004,2078
4316733,839,816,1655,185.0015,150.9985,336
4316758,2845,2852,5697,672,682,1354
4316808,56943,61431,118374,14811,15021,29832
4316907,123634,137397,261031,34285,35138,69423
4316956,3101,2952,6053,711,697,1408
4316972,1272,1080,2352,230,239,469
4317004,4169,4073,8242,819,790,1609
4317103,39376,43088,82464,8961.881,8987.398,17949.28
4317202,33483,35104,68587,8883,8698,17581
4317251,889,831,1720,172,146,318
4317301,15469,15521,30990,3438,3471,6909
4317400,23571,25500,49071,5842,5758,11600
4317509,36586,39689,76275,9330,9282,18612
4317558,1112,1027,2139,265,241,506
4317608,19756,19929,39685,4625,4494,9119
4317707,5579,5631,11210,1210,1148,2358
4317756,980,1007,1987,204,211,415
4317806,6811,7157,13968,1630,1632,3262
4317905,7190,7188,14378,1629,1495,3124
4317954,1239,1222,2461,282,237,519
4318002,30248,31423,61671,7621,7397,15018
4318051,1470,1456,2926,328,326,654
4318101,9493,9761,19254,2065,2105,4170
4318200,10402,10135,20537,2489,2292,4781
4318309,29429,30996,60425,7058,7006,14064
4318408,11026,11108,22134,2706,2624,5330
4318424,2401,2325,4726,487,457,944
4318432,1272,1363,2635,293,306,599
4318440,1379,1395,2774,305,312,617
4318457,1377,1343,2720,265,267,532
4318465,1136,1068,2204,248,224,472
4318481,2088,2006,4094,521,484,1005
4318499,1125,1075,2200,226,224,450
4318507,13003,12500,25503,3154,2862,6016
4318606,3382,3522,6904,742,706,1448
4318614,1052,1030,2082,233,219,452
4318622,1693,1597,3290,432,388,820
4318705,104242,109845,214087,28184,27944,56128
4318804,21623,21488,43111,5015,4847,9862
4318903,16827,17729,34556,4327,4137,8464
4319000,9859,10244,20103,2599,2495,5094
4319109,2838,2935,5773,606,582,1188
4319125,1647,1554,3201,302,312,614
4319158,3880,3541,7421,869,799,1668
4319208,2906,2821,5727,597,558,1155
4319307,3228,3136,6364,642,572,1214
4319356,1683,1632,3315,429,434,863
4319364,932,954,1886,196,223,419
4319372,1456,1417,2873,306,314,620
4319406,8050,8318,16368,1812,1707,3519
4319505,10738,11194,21932,2731,2770,5501
4319604,11777,12021,23798,2612,2567,5179
4319703,1811,1821,3632,381,377,758
4319711,1112,1056,2168,232,220,452
4319737,1375,1272,2647,333,303,636
4319752,994,950,1944,252,224,476
4319802,4206,4234,8440,957,956,1913
4319901,36989,37996,74985,9926,9831,19757
4320008,63747,67210,130957,16936,17054,33990
4320107,10269,11016,21285,2748,2796,5544
4320206,5349,5548,10897,1230,1231,2461
4320230,1531,1480,3011,318,291,609
4320263,3698,3460,7158,892,816,1708
4320305,2403,2526,4929,598,541,1139
4320321,1407,1407,2814,294,319,613
4320354,2666,2532,5198,613,565,1178
4320404,7099,7154,14253,1929,1840,3769
4320453,1190,1091,2281,277,213,490
4320503,3045,3249,6294,651,689,1340
4320552,2934,2916,5850,723,656,1379
4320578,1082,1042,2124,210,200,410
4320602,1942,1900,3842,423,425,848
4320651,1227,1222,2449,239.8667,249,488.8667
4320677,5217,4851,10068,1203,1094,2297
4320701,6992,7291,14283,1746,1759,3505
4320800,14729,15315,30044,3698,3732,7430
4320859,2102,2029,4131,500,463,963
4320909,9392,9858,19250,2774,2776,5550
4321006,5093,5355,10448,1317,1202,2519
4321105,8167,8462,16629,1813,1820,3633
4321204,26866,27777,54643,6543,6451,12994
4321303,12689,13403,26092,3111,3056,6167
4321329,1517,1449,2966,351,335,686
4321352,2777,2574,5351,599,497,1096
4321402,6713,7006,13719,1590,1635,3225
4321436,4959,4919,9878,1208,1160,2368
4321451,13523,13749,27272,3553,3470,7023
4321469,1372,1352,2724,341,342,683
4321477,3268,3193,6461,587,581,1168
4321493,1561,1391,2952,288,278,566
4321501,16835,17821,34656,4110,4126,8236
4321600,20095,21490,41585,4879,5033,9912
4321626,1171,1143,2314,243,209,452
4321634,1428,1427,2855,269,266,535
4321667,5156,5061,10217,1298,1232,2530
4321709,11837,12011,23848,3292,3147,6439
4321808,11484,12242,23726,2838,2876,5714
4321832,1512,1402,2914,303,282,585
4321857,2210,2171,4381,535,505,1040
4321907,11751,12214,23965,2751,2684,5435
4321956,2884,2903,5787,610,620,1230
4322004,12933,12860,25793,3292,3184,6476
4322103,2817,3081,5898,611,655,1266
4322152,2278,2117,4395,590,530,1120
4322186,816,757,1573,167.775,133.225,301
4322202,10864,11417,22281,2621,2670,5291
4322251,2068,1856,3924,560,494,1054
4322301,4146,4411,8557,880,845,1725
4322327,1778,1744,3522,416.8095,363.2271,780.0366
4322343,1183,1113,2296,252,199,451
4322350,797,690,1487,170,119,289
4322376,1245,1205,2450,245,252,497
4322400,61009,64426,125435,15403,15823,31226
4322509,30083,31259,61342,7475,7364,14839
4322525,1652,1601,3253,313,354,667
4322533,5597,5480,11077,1321,1288,2609
4322541,2570,2548,5118,697,713,1410
4322558,993,991,1984,227,243,470
4322608,32643,33303,65946,8091,7773,15864
4322707,11749,12234,23983,2897,2811,5708
4322806,11102,11708,22810,2801,2806,5607
4322855,1024,950,1974,191,162,353
4322905,2620,2691,5311,588,539,1127
4323002,116483,122901,239384,30002,29896,59898
4323101,2701,2584,5285,620,605,1225
4323200,1512,1524,3036,281,304,585
4323309,1617,1590,3207,415,357,772
4323358,1123,1029,2152,234,194,428
4323408,2116,2105,4221,527,471,998
4323457,2102,2119,4221,414,438,852
4323507,1400,1432,2832,316,328,644
4323606,819,750,1569,152.4843,135.5157,288
4323705,1395,1364,2759,296,292,588
4323754,1794,1691,3485,331,293,624
4323770,1406,1387,2793,346,300,646
4323804,6199,6235,12434,1618,1554,3172
5000203,7545,6879,14424,2104,2031,4135
5000252,2432,2137,4569,649,605,1254
5000609,17375,17355,34730,4720,4624,9344
5000708,11911,11924,23835,2995,3084,6079
5000807,4313,4180,8493,1086,1045,2131
5000856,4696,4489,9185,1248,1178,2426
5000906,4108,4100,8208,1021,1133,2154
5001003,11152,11168,22320,2948,2836,5784
5001102,22851,22763,45614,5887,5696,11583
5001243,5266,4985,10251,1401,1366,2767
5001508,3459,3150,6609,828,790,1618
5001904,10090,9749,19839,2730,2716,5446
5002001,5419,5517,10936,1374,1373,2747
5002100,11720,11461,23181,3185,2947,6132
5002159,4113,3872,7985,1080,1061,2141
5002209,9878,9709,19587,2524,2626,5150
5002308,6045,5781,11826,1620,1642,3262
5002407,12918,12849,25767,3471,3536,7007
5002605,7067,6558,13625,1738,1657,3395
5002704,381333,405464,786797,108479,108941,217420
5002803,2764,2634,5398,773,746,1519
5002902,10464,10502,20966,2613,2486,5099
5002951,10277,9371,19648,3081,2821,5902
5003108,2629,2233,4862,586,517,1103
5003157,6953,7111,14064,1734,1990,3724
5003207,52285,51418,103703,14572,13746,28318
5003256,10246,9449,19695,2823,2656,5479
5003306,16141,16018,32159,4353,4235,8588
5003454,6127,6012,12139,1601,1549,3150
5003488,5531,4832,10363,1462,1306,2768
5003504,2722,2642,5364,691,657,1348
5003702,96274,99761,196035,27305,27586,54891
5003751,5783,5911,11694,1579,1559,3138
5003801,9363,9672,19035,2292,2212,4504
5003900,1553,1375,2928,387,343,730
5004007,4894,5033,9927,1230,1181,2411
5004106,5208,5158,10366,1255,1284,2539
5004304,7427,7448,14875,1954,2022,3976
5004403,3964,3705,7669,930,951,1881
5004502,10407,10458,20865,2700,2715,5415
5004601,9712,8902,18614,2457,2336,4793
5004700,11269,11072,22341,2894,2842,5736
5004809,3908,3823,7731,972,973,1945
5004908,3407,2934,6341,725,617,1342
5005004,12130,12216,24346,3103,3096,6199
5005103,2090,1921,4011,551,514,1065
5005152,3010,2890,5900,775,726,1501
5005202,9829,9788,19617,2743,2682,5425
5005251,3295,3196,6491,829,846,1675
5005400,19387,18018,37405,5848,5354,11202
5005608,13221,12374,25595,3474,3268,6742
5005681,8260,8783,17043,2092,2265,4357
5005707,23226,23198,46424,6505,6492,12997
5005806,7547,6844,14391,1886,1755,3641
5006002,8478,7954,16432,2427,2396,4823
5006200,22733,22852,45585,6089,6074,12163
5006259,2513,2427,4940,672,613,1285
5006309,19957,20235,40192,5046,5076,10122
5006358,6261,6089,12350,1602,1647,3249
5006408,4149,3818,7967,1033,979,2012
5006606,38492,39380,77872,10322,10749,21071
5006903,8234,7138,15372,2305,2039,4344
5007109,10982,9964,20946,3080,2835,5915
5007208,15711,14952,30663,4513,4330,8843
5007307,2604,2432,5036,566,555,1121
5007406,9486,9404,18890,2418,2359,4777
5007505,2573,2355,4928,579,545,1124
5007554,3805,3454,7259,923,904,1827
5007695,11200,11003,22203,3108,3159,6267
5007703,5481,5299,10780,1355,1359,2714
5007802,3215,3072,6287,807,809,1616
5007901,21515,20617,42132,5811,5656,11467
5007935,7836,6997,14833,2361,2084,4445
5007950,5274,4941,10215,1399,1288,2687
5007976,1807,1711,3518,462,417,879
5008008,9146,8000,17146,2077,1972,4049
5008305,50523,51268,101791,13964,14006,27970
5008404,2959,2942,5901,651,676,1327
5100102,2900,2616,5516,716,673,1389
5100201,10932,9924,20856,3029,2778,5807
5100250,24989,24175,49164,6668,6703,13371
5100300,8011,7633,15644,2127,2002,4129
5100359,2732,2515,5247,668,698,1366
5100409,5438,4912,10350,1417,1257,2674
5100508,5413,4653,10066,1309,1264,2573
5100607,4277,3795,8072,1260,1119,2379
5100805,4663,3904,8567,1172,1109,2281
5101001,1637,1560,3197,376,412,788
5101209,585,511,1096,136.6494,97.35059,234
5101258,7583,7759,15342,2094,2216,4310
5101308,5191,5125,10316,1442,1331,2773
5101407,10077,8579,18656,2814,2519,5333
5101605,4134,3457,7591,1004,873,1877
5101704,16551,15242,31793,4674,4466,9140
5101803,28178,28382,56560,7648,7709,15357
5101852,2856,2458,5314,718,709,1427
5101902,8285,7072,15357,2319,2025,4344
5102504,44098,43844,87942,12006,11980,23986
5102603,7406,6899,14305,1742,1757,3499
5102637,14502,13075,27577,4398,4112,8510
5102678,16282,15307,31589,4683,4489,9172
5102686,2665,2489,5154,748,773,1521
5102694,2549,2237,4786,644,632,1276
5102702,9650,9104,18754,2606,2507,5113
5102793,5817,5173,10990,1329,1245,2574
5102850,4345,3886,8231,1081,1038,2119
5103007,9294,8527,17821,2324,2189,4513
5103056,5728,5300,11028,1531,1376,2907
5103106,2897,2593,5490,727,674,1401
5103205,15552,15214,30766,4173,4141,8314
5103254,14084,12297,26381,3876,3624,7500
5103304,9376,8802,18178,2560,2516,5076
5103353,13347,11777,25124,3578,3377,6955
5103361,1788,1597,3385,542,503,1045
5103379,7977,7006,14983,2112,2017,4129
5103403,269204,281894,551098,79177,80766,159943
5103437,2534,2332,4866,620,617,1237
5103452,4393,4130,8523,1176,1180,2356
5103502,10512,9829,20341,2969,2805,5774
5103601,4222,3949,8171,1025,932,1957
5103700,5580,5353,10933,1457,1524,2981
5103809,1936,1860,3796,494,488,982
5103858,3443,2850,6293,957,776,1733
5103908,2644,2383,5027,624,639,1263
5103957,1595,1540,3135,363,356,719
5104104,16511,15705,32216,4775,4787,9562
5104203,7287,6647,13934,1746,1563,3309
5104500,1249,1148,2397,309,308,617
5104526,2795,2328,5123,778,721,1499
5104542,2881,2395,5276,796,656,1452
5104559,2398,2177,4575,623,584,1207
5104609,6225,5253,11478,1622,1488,3110
5104807,12981,12666,25647,3534,3259,6793
5104906,3963,3733,7696,1022,980,2002
5105002,5259,5196,10455,1349,1355,2704
5105101,16956,15835,32791,4704,4387,9091
5105150,20136,19119,39255,5335,5229,10564
5105176,5808,5393,11201,1489,1539,3028
5105200,5960,5470,11430,1447,1381,2828
5105234,2852,2579,5431,810,753,1563
5105259,24016,21540,45556,8476,7283,15759
5105309,1146,1078,2224,323.7927,247.5482,571.3409
5105507,7565,6928,14493,2036,1969,4005
5105580,6368,5638,12006,1631,1523,3154
5105606,7357,6817,14174,1964,1863,3827
5105622,12685,12614,25299,3582,3509,7091
5105903,7830,7172,15002,1922.966,1918.841,3841.807
5106000,3310,3126,6436,888,822,1710
5106109,6270,5339,11609,1528,1284,2812
5106158,6378,5265,11643,1610,1420,3030
5106174,1565,1464,3029,375,378,753
5106182,2916,2520,5436,769,733,1502
5106190,1811,1657,3468,479,429,908
5106208,2401,2186,4587,593,574,1167
5106216,6453,5674,12127,1650,1492,3142
5106224,16799,14850,31649,5941,5059,11000
5106232,9056,8459,17515,2468,2488,4956
5106240,5132,4086,9218,1484,1197,2681
5106257,10028,9615,19643,2700,2575,5275
5106265,3916,3416,7332,966,908,1874
5106273,1936,1813,3749,464,435,899
5106281,3141,2901,6042,741,719,1460
5106299,5741,4943,10684,1399,1292,2691
5106307,10310,8980,19290,2733,2515,5248
5106315,1105,900,2005,283,227,510
5106372,8115,7640,15755,2018,1942,3960
5106422,15970,14842,30812,4215,4122,8337
5106455,1400,1326,2726,337,328,665
5106505,16519,15260,31779,4429,4103,8532
5106653,2776,2619,5395,726,714,1440
5106703,919,849,1768,183.195,192.805,376
5106752,20922,20486,41408,5889,5922,11811
5106778,5737,5011,10748,1518,1379,2897
5106802,2860,2589,5449,695,715,1410
5106828,5899,5132,11031,1526,1427,2953
5106851,1903,1746,3649,464,424,888
5107008,9258,8341,17599,2171,1925,4096
5107040,26487,25579,52066,8114,7822,15936
5107065,6924,6109,13033,1968,1814,3782
5107107,9501,9497,18998,2457,2527,4984
5107156,1322,1250,2572,347,335,682
5107180,4608,4273,8881,1193,1134,2327
5107198,1126,1073,2199,248,271,519
5107206,2537,2533,5070,720,683,1403
5107248,2147,1938,4085,577,532,1109
5107263,1628,1363,2991,398,365,763
5107297,1926,1666,3592,464,354,818
5107305,9185,7939,17124,2620,2228,4848
5107354,2824,2416,5240,800,715,1515
5107404,2149,2009,4158,541,522,1063
5107578,1902,1702,3604,539,514,1053
5107602,98197,97279,195476,28029,27343,55372
5107701,9415,8264,17679,2374,2035,4409
5107743,1046,854,1900,271,233,504
5107750,2017,1891,3908,520,495,1015
5107768,1362,1129,2491,450,343,793
5107776,3938,3459,7397,1057,926,1983
5107792,2025,1729,3754,583,481,1064
5107800,9861,8602,18463,2405,2133,4538
5107859,5562,5063,10625,1343,1259,2602
5107875,9776,8318,18094,3246,2643,5889
5107883,743,622,1365,184,157,341
5107909,57565,55534,113099,16717,16472,33189
5107925,34267,32254,66521,10216,9798,20014
5107941,5308,4624,9932,1364,1286,2650
5107958,41990,41441,83431,12323,12212,24535
5108006,6059,4333,10392,2247,1355,3602
5108055,5884,5407,11291,1485,1387,2872
5108105,1903,1515,3418,429,396,825
5108204,2120,1951,4071,504,440,944
5108303,2044,1716,3760,539,483,1022
5108352,1643,1409,3052,431,364,795
5108402,125267,127329,252596,36197,37109,73306
5108501,5304,4931,10235,1383,1329,2712
5108600,11188,10194,21382,3090,3039,6129
5108808,2582,2350,4932,596,576,1172
5108857,1591,1360,2951,410,396,806
5108907,3599,2991,6590,930,834,1764
5108956,4388,3705,8093,1084,1031,2115
5200050,3371,3505,6876,943,917,1860
5200100,8089,7668,15757,2101,2076,4177
5200134,10379,9900,20279,2708,2590,5298
5200159,1273,1204,2477,298,318,616
5200175,2731,2359,5090,701,584,1285
5200209,1048,965,2013,235,228,463
5200258,79726,79652,159378,22847,23549,46396
5200308,12010,11804,23814,3013,2953,5966
5200506,1048,1003,2051,226,193,419
5200555,2351,2154,4505,681,612,1293
5200605,3408,3477,6885,934,957,1891
5200803,4108,3976,8084,1082,1054,2136
5200829,1833,1601,3434,424,399,823
5200852,2858,2650,5508,699,641,1340
5200902,1830,1779,3609,350,352,702
5201108,163256,171357,334613,44841,44715,89556
5201207,516,504,1020,126.3113,102.6887,229
5201306,10407,9832,20239,2762,2543,5305
5201405,224798,230859,455657,68122,67548,135670
5201454,1241,1186,2427,332,307,639
5201504,2005,1798,3803,541,458,999
5201603,1909,1893,3802,464,389,853
5201702,9186,9119,18305,2522,2447,4969
5201801,4265,4100,8365,1047,1025,2072
5202155,3851,3659,7510,915,908,1823
5202353,1676,1601,3277,342,330,672
5202502,3921,3575,7496,974,974,1948
5202601,1839,1811,3650,412,403,815
5202809,1234,1216,2450,294,275,569
5203104,2043,1671,3714,429,394,823
5203203,4509,4207,8716,1211,1124,2335
5203302,12612,11942,24554,3201,3078,6279
5203401,4304,4119,8423,973,911,1884
5203500,10757,9970,20727,3017,2609,5626
5203559,3777,3759,7536,987,929,1916
5203575,1834,1669,3503,458,419,877
5203609,1646,1586,3232,409,371,780
5203807,2809,2700,5509,662,637,1299
5203906,4535,4519,9054,1034,975,2009
5203939,1321,1239,2560,297,301,598
5203962,1703,1618,3321,490,431,921
5204003,3778,3576,7354,1022,975,1997
5204102,5749,4804,10553,1612,1246,2858
5204201,731,686,1417,171.7985,160.2015,332
5204250,4173,4081,8254,975,987,1962
5204300,7031,6252,13283,1771,1556,3327
5204409,8545,8212,16757,2060,1970,4030
5204508,35021,35452,70473,9390,9498,18888
5204557,1689,1636,3325,412,410,822
5204607,1772,1615,3387,457,403,860
5204656,1938,1718,3656,431,393,824
5204706,5701,5410,11111,1469,1447,2916
5204805,3108,2952,6060,731,755,1486
5204854,3185,3056,6241,814,815,1629
5204904,9125,9285,18410,2603,2696,5299
5204953,2571,2449,5020,648,586,1234
5205000,4547,4381,8928,1125,1012,2137
5205059,1918,1720,3638,494,412,906
5205109,43536,43111,86647,12239,11694,23933
5205208,2398,2288,4686,598,538,1136
5205307,4915,4477,9392,1217,1140,2357
5205406,10144,10578,20722,2558,2618,5176
5205455,3871,3674,7545,997,954,1951
5205471,3664,3337,7001,1135,1086,2221
5205497,27430,28485,55915,7859,8205,16064
5205513,8952,8455,17407,2355,2281,4636
5205521,1838,1685,3523,441,408,849
5205703,1338,1294,2632,284,267,551
5205802,5415,4946,10361,1301,1179,2480
5205901,4284,3897,8181,1035,989,2024
5206206,23977,22603,46580,6591,6310,12901
5206305,1503,1429,2932,339,333,672
5206404,8254,7506,15760,2021,1975,3996
5206503,1794,1761,3555,378,385,763
5206602,1515,1449,2964,320,303,623
5206701,1709,1583,3292,422,416,838
5206800,1383,1364,2747,350,316,666
5206909,1082,974,2056,221,195,416
5207105,1262,1217,2479,295,272,567
5207253,4162,3730,7892,928,908,1836
5207352,1930,1803,3733,387,401,788
5207402,5779,5487,11266,1416,1315,2731
5207501,1720,1600,3320,468,374,842
5207535,3652,3331,6983,711,705,1416
5207600,3248,3074,6322,677,670,1347
5207808,5701,5879,11580,1305,1334,2639
5207907,6657,5409,12066,1731,1496,3227
5208004,49959,50126,100085,14418,14355,28773
5208103,2474,2409,4883,556,544,1100
5208152,1724,1551,3275,370,327,697
5208301,2595,2367,4962,658,584,1242
5208400,5453,5242,10695,1414,1406,2820
5208509,2633,2632,5265,618,581,1199
5208608,30075,29474,59549,8411,7798,16209
5208707,620857,681144,1302001,183658.9,192647.5,376306.4
5208806,17120,16940,34060,4789,4817,9606
5208905,12256,12471,24727,2851,2895,5746
5209101,16219,16273,32492,4026,3865,7891
5209150,2569,2380,4949,645,558,1203
5209200,6970,7006,13976,1713,1697,3410
5209291,1187,1189,2376,254,241,495
5209408,2291,1967,4258,621,483,1104
5209457,1225,1074,2299,235,239,474
5209606,1830,1741,3571,447,432,879
5209705,8942,8456,17398,2345,2198,4543
5209804,2043,1986,4029,475,423,898
5209903,6379,6048,12427,1704,1683,3387
5209937,2917,2782,5699,757,685,1442
5209952,7086,6601,13687,1797.972,1696.875,3494.847
5210000,23666,24580,48246,6374,6288,12662
5210109,12444,12291,24735,3196,2948,6144
5210158,1451,1393,2844,298,290,588
5210208,15302,15972,31274,3711,3812,7523
5210307,1463,1424,2887,334,328,662
5210406,17849,17522,35371,4972,4728,9700
5210562,2276,2237,4513,528,541,1069
5210604,2742,2695,5437,602,573,1175
5210802,2508,2554,5062,657,642,1299
5210901,9379,9079,18458,2476,2332,4808
5211008,3963,3872,7835,860,829,1689
5211206,12922,13203,26125,3106,3071,6177
5211305,3318,2982,6300,854,783,1637
5211404,4235,4340,8575,1005,981,1986
5211503,45796,47087,92883,11688,11418,23106
5211602,1405,1258,2663,262,272,534
5211701,3175,2989,6164,704,618,1322
5211800,21241,20629,41870,5648,5522,11170
5211909,43961,44045,88006,11884,11510,23394
5212006,1517,1483,3000,292,314,606
5212055,1206,1094,2300,276,257,533
5212105,3608,3510,7118,985,868,1853
5212204,9587,9566,19153,2318,2283,4601
5212253,643,611,1254,171,144,315
5212303,4013,3869,7882,1015,965,1980
5212501,87087,87444,174531,24545,24716,49261
5212600,1238,1136,2374,276,252,528
5212709,3529,3342,6871,1028,955,1983
5212808,5426,5223,10649,1292,1241,2533
5212907,1026,1046,2072,258,245,503
5212956,2254,2160,4414,516,547,1063
5213004,6022,5499,11521,1771,1576,3347
5213053,1427,1258,2685,303,272.5333,575.5333
5213087,15837,15317,31154,3969,3963,7932
5213103,27140,25795,52935,8110,7505,15615
5213400,899,864,1763,176.05,170.95,347
5213509,3994,3736,7730,1013,984,1997
5213707,4094,3893,7987,973,924,1897
5213756,5499,5073,10572,1566,1479,3045
5213772,2109,2013,4122,438,441,879
5213806,20773,20687,41460,5232,4968,10200
5213855,1173,1183,2356,246,240,486
5213905,2557,2450,5007,609,589,1198
5214002,6843,6561,13404,1856,1858,3714
5214051,3428,3010,6438,768,730,1498
5214101,2003,1846,3849,441,412,853
5214408,3963,3911,7874,969,976,1945
5214507,11923,12287,24210,3400,3451,6851
5214606,21689,20672,42361,5651,5586,11237
5214705,1158,1101,2259,261,235,496
5214804,1074,988,2062,223,212,435
5214838,6223,5704,11927,1582,1510,3092
5214861,4246,4262,8508,895,957,1852
5214879,1455,1371,2826,363,348,711
5214903,1794,1677,3471,401,375,776
5215009,4128,4001,8129,1114,1019,2133
5215207,1819,1700,3519,388,386,774
5215231,46672,48346,95018,13307,14126,27433
5215256,2072,1884,3956,448,459,907
5215306,7389,6911,14300,1731,1631,3362
5215405,2008,2026,4034,475,496,971
5215504,2811,2656,5467,733,642,1375
5215603,13992,13679,27671,3566,3515,7081
5215652,1776,1595,3371,439,443,882
5215702,11819,11519,23338,3311,3040,6351
5215801,1149,1186,2335,268,228,496
5215900,1779,1778,3557,398,380,778
5216007,1370,1312,2682,301,276,577
5216304,4588,4512,9100,1197,1095,2292
5216403,5521,5342,10863,1334,1274,2608
5216452,1570,1380,2950,357,362,719
5216809,5368,4915,10283,1360,1178,2538
5216908,1467,1306,2773,329,301,630
5217104,12194,11832,24026,2753,2579,5332
5217203,5718,5548,11266,1285,1259,2544
5217302,11797,11209,23006,2952,2618,5570
5217401,14105,14657,28762,3617,3531,7148
5217609,40574,41075,81649,11922,11986,23908
5217708,8578,8543,17121,1937,1935,3872
5218003,21285,21070,42355,5588,5541,11129
5218052,1808,1539,3347,504,419,923
5218102,1986,1853,3839,500,456,956
5218300,15925,15494,31419,4610,4491,9101
5218391,1676,1563,3239,378,347,725
5218508,21934,21286,43220,5538.854,5364.547,10903.4
5218607,5239,5284,10523,1288,1301,2589
5218706,2319,2247,4566,565,551,1116
5218789,1733,1579,3312,407.8667,407,814.8666
5218805,90030,86394,176424,28546,26079,54625
5218904,9429,9486,18915,2355,2261,4616
5219001,3843,3707,7550,911,878,1789
5219100,2932,2819,5751,817,726,1543
5219209,1645,1497,3142,329,310,639
5219258,2405,2357,4762,606,618,1224
5219308,18317,18152,36469,4735,4657,9392
5219357,1906,1780,3686,425,371,796
5219407,3545,3379,6924,911,891,1802
5219456,1727,1446,3173,435,355,790
5219506,1452,1457,2909,318,309,627
5219605,1994,2001,3995,452,431,883
5219704,5261,5041,10302,1323,1222,2545
5219712,2346,2077,4423,627,495,1122
5219738,2389,2314,4703,681,629,1310
5219753,31371,31877,63248,8912,9182,18094
5219803,5928,5344,11272,1552,1404,2956
5219902,3147,2973,6120,733,699,1432
5220009,5274,4983,10257,1441,1315,2756
5220058,843,846,1689,181,188,369
5220108,14731,15303,30034,3814,3796,7610
5220157,2334,2283,4617,599,564,1163
5220207,11391,10892,22283,2800,2791,5591
5220264,1944,1813,3757,438,419,857
5220280,1000,991,1991,205,237,442
5220405,8866,8222,17088,2419,2066,4485
5220454,42211,42232,84443,13202.84,12228.61,25431.45
5220504,3970,3511,7481,1068,933,2001
5220603,9807,9282,19089,2349,2183,4532
5220686,3303,3211,6514,963,929,1892
5220702,1519,1306,2825,429,337,766
5221007,1766,1775,3541,447,409,856
5221080,1542,1474,3016,432,420,852
5221197,3346,3215,6561,864,859,1723
5221304,1424,1395,2819,322,315,637
5221403,51445,53043,104488,14271,14177,28448
5221452,1784,1668,3452,374,347,721
5221502,2431,2408,4839,520,532,1052
5221551,2338,2061,4399,634,608,1242
5221577,1525,1408,2933,292.1333,292,584.1334
5221601,18437,18492,36929,4825,4644,9469
5221700,7006,6820,13826,1694,1605,3299
5221809,1562,1512,3074,353,339,692
5221858,64624,68358,132982,19219,20490,39709
5221908,1852,1807,3659,396,396,792
5222005,6297,6251,12548,1599,1581,3180
5222054,3873,3498,7371,1057,949,2006
5222203,2588,2147,4735,803,649,1452
5222302,2689,2456,5145,597,594,1191
5300108,1228880,1341280,2570160,356227.8,377109.9,733337.7
